Date,BGT North of NE 70th Total,Ped South,Ped North,Bike North,Bike South
01/01/2024 12:00:00 AM,3,,,1,2
01/01/2024 01:00:00 AM,1,,,0,1
01/01/2024 02:00:00 AM,0,,,0,0
01/01/2024 03:00:00 AM,0,,,0,0
01/01/2024 04:00:00 AM,0,,,0,0
01/01/2024 05:00:00 AM,0,,,0,0
01/01/2024 06:00:00 AM,0,,,0,0
01/01/2024 07:00:00 AM,4,,,2,2
01/01/2024 08:00:00 AM,18,,,9,9
01/01/2024 09:00:00 AM,27,,,13,14
01/01/2024 10:00:00 AM,43,,,21,22
01/01/2024 11:00:00 AM,78,,,39,39
01/01/2024 12:00:00 PM,80,,,40,40
01/01/2024 01:00:00 PM,76,,,38,38
01/01/2024 02:00:00 PM,87,,,43,44
01/01/2024 03:00:00 PM,79,,,39,40
01/01/2024 04:00:00 PM,50,,,25,25
01/01/2024 05:00:00 PM,17,,,8,9
01/01/2024 06:00:00 PM,2,,,1,1
01/01/2024 07:00:00 PM,2,,,1,1
01/01/2024 08:00:00 PM,2,,,1,1
01/01/2024 09:00:00 PM,1,,,0,1
01/01/2024 10:00:00 PM,0,,,0,0
01/01/2024 11:00:00 PM,0,,,0,0
01/02/2024 12:00:00 AM,1,,,0,1
01/02/2024 01:00:00 AM,0,,,0,0
01/02/2024 02:00:00 AM,0,,,0,0
01/02/2024 03:00:00 AM,0,,,0,0
01/02/2024 04:00:00 AM,3,,,1,2
01/02/2024 05:00:00 AM,5,,,2,3
01/02/2024 06:00:00 AM,8,,,4,4
01/02/2024 07:00:00 AM,21,,,10,11
01/02/2024 08:00:00 AM,39,,,19,20
01/02/2024 09:00:00 AM,16,,,8,8
01/02/2024 10:00:00 AM,13,,,6,7
01/02/2024 11:00:00 AM,14,,,7,7
01/02/2024 12:00:00 PM,13,,,6,7
01/02/2024 01:00:00 PM,10,,,5,5
01/02/2024 02:00:00 PM,16,,,8,8
01/02/2024 03:00:00 PM,16,,,8,8
01/02/2024 04:00:00 PM,23,,,11,12
01/02/2024 05:00:00 PM,28,,,14,14
01/02/2024 06:00:00 PM,14,,,7,7
01/02/2024 07:00:00 PM,5,,,2,3
01/02/2024 08:00:00 PM,6,,,3,3
01/02/2024 09:00:00 PM,2,,,1,1
01/02/2024 10:00:00 PM,0,,,0,0
01/02/2024 11:00:00 PM,1,,,0,1
01/03/2024 12:00:00 AM,0,,,0,0
01/03/2024 01:00:00 AM,0,,,0,0
01/03/2024 02:00:00 AM,0,,,0,0
01/03/2024 03:00:00 AM,0,,,0,0
01/03/2024 04:00:00 AM,1,,,0,1
01/03/2024 05:00:00 AM,5,,,2,3
01/03/2024 06:00:00 AM,12,,,6,6
01/03/2024 07:00:00 AM,17,,,8,9
01/03/2024 08:00:00 AM,46,,,23,23
01/03/2024 09:00:00 AM,32,,,16,16
01/03/2024 10:00:00 AM,24,,,12,12
01/03/2024 11:00:00 AM,31,,,15,16
01/03/2024 12:00:00 PM,21,,,10,11
01/03/2024 01:00:00 PM,37,,,18,19
01/03/2024 02:00:00 PM,29,,,14,15
01/03/2024 03:00:00 PM,20,,,10,10
01/03/2024 04:00:00 PM,43,,,21,22
01/03/2024 05:00:00 PM,43,,,21,22
01/03/2024 06:00:00 PM,13,,,6,7
01/03/2024 07:00:00 PM,6,,,3,3
01/03/2024 08:00:00 PM,3,,,1,2
01/03/2024 09:00:00 PM,0,,,0,0
01/03/2024 10:00:00 PM,1,,,0,1
01/03/2024 11:00:00 PM,1,,,0,1
01/04/2024 12:00:00 AM,0,,,0,0
01/04/2024 01:00:00 AM,0,,,0,0
01/04/2024 02:00:00 AM,0,,,0,0
01/04/2024 03:00:00 AM,0,,,0,0
01/04/2024 04:00:00 AM,0,,,0,0
01/04/2024 05:00:00 AM,8,,,4,4
01/04/2024 06:00:00 AM,9,,,4,5
01/04/2024 07:00:00 AM,20,,,10,10
01/04/2024 08:00:00 AM,38,,,19,19
01/04/2024 09:00:00 AM,24,,,12,12
01/04/2024 10:00:00 AM,11,,,5,6
01/04/2024 11:00:00 AM,16,,,8,8
01/04/2024 12:00:00 PM,21,,,10,11
01/04/2024 01:00:00 PM,19,,,9,10
01/04/2024 02:00:00 PM,16,,,8,8
01/04/2024 03:00:00 PM,29,,,14,15
01/04/2024 04:00:00 PM,32,,,16,16
01/04/2024 05:00:00 PM,48,,,24,24
01/04/2024 06:00:00 PM,20,,,10,10
01/04/2024 07:00:00 PM,7,,,3,4
01/04/2024 08:00:00 PM,5,,,2,3
01/04/2024 09:00:00 PM,4,,,2,2
01/04/2024 10:00:00 PM,3,,,1,2
01/04/2024 11:00:00 PM,0,,,0,0
01/05/2024 12:00:00 AM,0,,,0,0
01/05/2024 01:00:00 AM,0,,,0,0
01/05/2024 02:00:00 AM,0,,,0,0
01/05/2024 03:00:00 AM,0,,,0,0
01/05/2024 04:00:00 AM,1,,,0,1
01/05/2024 05:00:00 AM,2,,,1,1
01/05/2024 06:00:00 AM,10,,,5,5
01/05/2024 07:00:00 AM,15,,,7,8
01/05/2024 08:00:00 AM,33,,,16,17
01/05/2024 09:00:00 AM,23,,,11,12
01/05/2024 10:00:00 AM,37,,,18,19
01/05/2024 11:00:00 AM,21,,,10,11
01/05/2024 12:00:00 PM,22,,,11,11
01/05/2024 01:00:00 PM,18,,,9,9
01/05/2024 02:00:00 PM,20,,,10,10
01/05/2024 03:00:00 PM,10,,,5,5
01/05/2024 04:00:00 PM,19,,,9,10
01/05/2024 05:00:00 PM,25,,,12,13
01/05/2024 06:00:00 PM,5,,,2,3
01/05/2024 07:00:00 PM,5,,,2,3
01/05/2024 08:00:00 PM,0,,,0,0
01/05/2024 09:00:00 PM,1,,,0,1
01/05/2024 10:00:00 PM,0,,,0,0
01/05/2024 11:00:00 PM,0,,,0,0
01/06/2024 12:00:00 AM,0,,,0,0
01/06/2024 01:00:00 AM,0,,,0,0
01/06/2024 02:00:00 AM,0,,,0,0
01/06/2024 03:00:00 AM,1,,,0,1
01/06/2024 04:00:00 AM,0,,,0,0
01/06/2024 05:00:00 AM,0,,,0,0
01/06/2024 06:00:00 AM,1,,,0,1
01/06/2024 07:00:00 AM,5,,,2,3
01/06/2024 08:00:00 AM,9,,,4,5
01/06/2024 09:00:00 AM,20,,,10,10
01/06/2024 10:00:00 AM,33,,,16,17
01/06/2024 11:00:00 AM,61,,,30,31
01/06/2024 12:00:00 PM,54,,,27,27
01/06/2024 01:00:00 PM,67,,,33,34
01/06/2024 02:00:00 PM,61,,,30,31
01/06/2024 03:00:00 PM,61,,,30,31
01/06/2024 04:00:00 PM,19,,,9,10
01/06/2024 05:00:00 PM,4,,,2,2
01/06/2024 06:00:00 PM,2,,,1,1
01/06/2024 07:00:00 PM,2,,,1,1
01/06/2024 08:00:00 PM,0,,,0,0
01/06/2024 09:00:00 PM,0,,,0,0
01/06/2024 10:00:00 PM,0,,,0,0
01/06/2024 11:00:00 PM,0,,,0,0
01/07/2024 12:00:00 AM,0,,,0,0
01/07/2024 01:00:00 AM,0,,,0,0
01/07/2024 02:00:00 AM,0,,,0,0
01/07/2024 03:00:00 AM,0,,,0,0
01/07/2024 04:00:00 AM,0,,,0,0
01/07/2024 05:00:00 AM,0,,,0,0
01/07/2024 06:00:00 AM,0,,,0,0
01/07/2024 07:00:00 AM,4,,,2,2
01/07/2024 08:00:00 AM,9,,,4,5
01/07/2024 09:00:00 AM,18,,,9,9
01/07/2024 10:00:00 AM,35,,,17,18
01/07/2024 11:00:00 AM,52,,,26,26
01/07/2024 12:00:00 PM,54,,,27,27
01/07/2024 01:00:00 PM,48,,,24,24
01/07/2024 02:00:00 PM,58,,,29,29
01/07/2024 03:00:00 PM,46,,,23,23
01/07/2024 04:00:00 PM,33,,,16,17
01/07/2024 05:00:00 PM,9,,,4,5
01/07/2024 06:00:00 PM,5,,,2,3
01/07/2024 07:00:00 PM,0,,,0,0
01/07/2024 08:00:00 PM,0,,,0,0
01/07/2024 09:00:00 PM,0,,,0,0
01/07/2024 10:00:00 PM,0,,,0,0
01/07/2024 11:00:00 PM,2,,,1,1
01/08/2024 12:00:00 AM,0,,,0,0
01/08/2024 01:00:00 AM,0,,,0,0
01/08/2024 02:00:00 AM,0,,,0,0
01/08/2024 03:00:00 AM,0,,,0,0
01/08/2024 04:00:00 AM,0,,,0,0
01/08/2024 05:00:00 AM,6,,,3,3
01/08/2024 06:00:00 AM,6,,,3,3
01/08/2024 07:00:00 AM,13,,,6,7
01/08/2024 08:00:00 AM,20,,,10,10
01/08/2024 09:00:00 AM,9,,,4,5
01/08/2024 10:00:00 AM,8,,,4,4
01/08/2024 11:00:00 AM,6,,,3,3
01/08/2024 12:00:00 PM,4,,,2,2
01/08/2024 01:00:00 PM,12,,,6,6
01/08/2024 02:00:00 PM,11,,,5,6
01/08/2024 03:00:00 PM,12,,,6,6
01/08/2024 04:00:00 PM,20,,,10,10
01/08/2024 05:00:00 PM,18,,,9,9
01/08/2024 06:00:00 PM,11,,,5,6
01/08/2024 07:00:00 PM,5,,,2,3
01/08/2024 08:00:00 PM,0,,,0,0
01/08/2024 09:00:00 PM,2,,,1,1
01/08/2024 10:00:00 PM,1,,,0,1
01/08/2024 11:00:00 PM,0,,,0,0
01/09/2024 12:00:00 AM,0,,,0,0
01/09/2024 01:00:00 AM,0,,,0,0
01/09/2024 02:00:00 AM,0,,,0,0
01/09/2024 03:00:00 AM,0,,,0,0
01/09/2024 04:00:00 AM,1,,,0,1
01/09/2024 05:00:00 AM,5,,,2,3
01/09/2024 06:00:00 AM,4,,,2,2
01/09/2024 07:00:00 AM,14,,,7,7
01/09/2024 08:00:00 AM,25,,,12,13
01/09/2024 09:00:00 AM,14,,,7,7
01/09/2024 10:00:00 AM,5,,,2,3
01/09/2024 11:00:00 AM,10,,,5,5
01/09/2024 12:00:00 PM,10,,,5,5
01/09/2024 01:00:00 PM,16,,,8,8
01/09/2024 02:00:00 PM,10,,,5,5
01/09/2024 03:00:00 PM,18,,,9,9
01/09/2024 04:00:00 PM,25,,,12,13
01/09/2024 05:00:00 PM,37,,,18,19
01/09/2024 06:00:00 PM,20,,,10,10
01/09/2024 07:00:00 PM,7,,,3,4
01/09/2024 08:00:00 PM,4,,,2,2
01/09/2024 09:00:00 PM,0,,,0,0
01/09/2024 10:00:00 PM,1,,,0,1
01/09/2024 11:00:00 PM,1,,,0,1
01/10/2024 12:00:00 AM,0,,,0,0
01/10/2024 01:00:00 AM,0,,,0,0
01/10/2024 02:00:00 AM,0,,,0,0
01/10/2024 03:00:00 AM,0,,,0,0
01/10/2024 04:00:00 AM,0,,,0,0
01/10/2024 05:00:00 AM,6,,,3,3
01/10/2024 06:00:00 AM,15,,,7,8
01/10/2024 07:00:00 AM,17,,,8,9
01/10/2024 08:00:00 AM,30,,,15,15
01/10/2024 09:00:00 AM,18,,,9,9
01/10/2024 10:00:00 AM,23,,,11,12
01/10/2024 11:00:00 AM,31,,,15,16
01/10/2024 12:00:00 PM,25,,,12,13
01/10/2024 01:00:00 PM,13,,,6,7
01/10/2024 02:00:00 PM,34,,,17,17
01/10/2024 03:00:00 PM,30,,,15,15
01/10/2024 04:00:00 PM,39,,,19,20
01/10/2024 05:00:00 PM,42,,,21,21
01/10/2024 06:00:00 PM,25,,,12,13
01/10/2024 07:00:00 PM,1,,,0,1
01/10/2024 08:00:00 PM,4,,,2,2
01/10/2024 09:00:00 PM,1,,,0,1
01/10/2024 10:00:00 PM,0,,,0,0
01/10/2024 11:00:00 PM,0,,,0,0
01/11/2024 12:00:00 AM,0,,,0,0
01/11/2024 01:00:00 AM,0,,,0,0
01/11/2024 02:00:00 AM,0,,,0,0
01/11/2024 03:00:00 AM,0,,,0,0
01/11/2024 04:00:00 AM,0,,,0,0
01/11/2024 05:00:00 AM,5,,,2,3
01/11/2024 06:00:00 AM,6,,,3,3
01/11/2024 07:00:00 AM,18,,,9,9
01/11/2024 08:00:00 AM,25,,,12,13
01/11/2024 09:00:00 AM,19,,,9,10
01/11/2024 10:00:00 AM,12,,,6,6
01/11/2024 11:00:00 AM,14,,,7,7
01/11/2024 12:00:00 PM,21,,,10,11
01/11/2024 01:00:00 PM,27,,,13,14
01/11/2024 02:00:00 PM,23,,,11,12
01/11/2024 03:00:00 PM,30,,,15,15
01/11/2024 04:00:00 PM,32,,,16,16
01/11/2024 05:00:00 PM,18,,,9,9
01/11/2024 06:00:00 PM,9,,,4,5
01/11/2024 07:00:00 PM,3,,,1,2
01/11/2024 08:00:00 PM,0,,,0,0
01/11/2024 09:00:00 PM,0,,,0,0
01/11/2024 10:00:00 PM,0,,,0,0
01/11/2024 11:00:00 PM,0,,,0,0
01/12/2024 12:00:00 AM,0,,,0,0
01/12/2024 01:00:00 AM,0,,,0,0
01/12/2024 02:00:00 AM,0,,,0,0
01/12/2024 03:00:00 AM,0,,,0,0
01/12/2024 04:00:00 AM,0,,,0,0
01/12/2024 05:00:00 AM,3,,,1,2
01/12/2024 06:00:00 AM,5,,,2,3
01/12/2024 07:00:00 AM,2,,,1,1
01/12/2024 08:00:00 AM,4,,,2,2
01/12/2024 09:00:00 AM,5,,,2,3
01/12/2024 10:00:00 AM,9,,,4,5
01/12/2024 11:00:00 AM,4,,,2,2
01/12/2024 12:00:00 PM,5,,,2,3
01/12/2024 01:00:00 PM,5,,,2,3
01/12/2024 02:00:00 PM,2,,,1,1
01/12/2024 03:00:00 PM,7,,,3,4
01/12/2024 04:00:00 PM,9,,,4,5
01/12/2024 05:00:00 PM,4,,,2,2
01/12/2024 06:00:00 PM,3,,,1,2
01/12/2024 07:00:00 PM,0,,,0,0
01/12/2024 08:00:00 PM,1,,,0,1
01/12/2024 09:00:00 PM,2,,,1,1
01/12/2024 10:00:00 PM,0,,,0,0
01/12/2024 11:00:00 PM,0,,,0,0
01/13/2024 12:00:00 AM,2,,,1,1
01/13/2024 01:00:00 AM,0,,,0,0
01/13/2024 02:00:00 AM,0,,,0,0
01/13/2024 03:00:00 AM,0,,,0,0
01/13/2024 04:00:00 AM,0,,,0,0
01/13/2024 05:00:00 AM,0,,,0,0
01/13/2024 06:00:00 AM,0,,,0,0
01/13/2024 07:00:00 AM,0,,,0,0
01/13/2024 08:00:00 AM,3,,,1,2
01/13/2024 09:00:00 AM,2,,,1,1
01/13/2024 10:00:00 AM,0,,,0,0
01/13/2024 11:00:00 AM,6,,,3,3
01/13/2024 12:00:00 PM,4,,,2,2
01/13/2024 01:00:00 PM,5,,,2,3
01/13/2024 02:00:00 PM,10,,,5,5
01/13/2024 03:00:00 PM,1,,,0,1
01/13/2024 04:00:00 PM,4,,,2,2
01/13/2024 05:00:00 PM,2,,,1,1
01/13/2024 06:00:00 PM,1,,,0,1
01/13/2024 07:00:00 PM,1,,,0,1
01/13/2024 08:00:00 PM,0,,,0,0
01/13/2024 09:00:00 PM,0,,,0,0
01/13/2024 10:00:00 PM,0,,,0,0
01/13/2024 11:00:00 PM,0,,,0,0
01/14/2024 12:00:00 AM,0,,,0,0
01/14/2024 01:00:00 AM,0,,,0,0
01/14/2024 02:00:00 AM,0,,,0,0
01/14/2024 03:00:00 AM,0,,,0,0
01/14/2024 04:00:00 AM,0,,,0,0
01/14/2024 05:00:00 AM,0,,,0,0
01/14/2024 06:00:00 AM,0,,,0,0
01/14/2024 07:00:00 AM,0,,,0,0
01/14/2024 08:00:00 AM,1,,,0,1
01/14/2024 09:00:00 AM,2,,,1,1
01/14/2024 10:00:00 AM,7,,,3,4
01/14/2024 11:00:00 AM,7,,,3,4
01/14/2024 12:00:00 PM,15,,,7,8
01/14/2024 01:00:00 PM,25,,,12,13
01/14/2024 02:00:00 PM,17,,,8,9
01/14/2024 03:00:00 PM,21,,,10,11
01/14/2024 04:00:00 PM,11,,,5,6
01/14/2024 05:00:00 PM,5,,,2,3
01/14/2024 06:00:00 PM,0,,,0,0
01/14/2024 07:00:00 PM,0,,,0,0
01/14/2024 08:00:00 PM,0,,,0,0
01/14/2024 09:00:00 PM,0,,,0,0
01/14/2024 10:00:00 PM,0,,,0,0
01/14/2024 11:00:00 PM,0,,,0,0
01/15/2024 12:00:00 AM,0,,,0,0
01/15/2024 01:00:00 AM,0,,,0,0
01/15/2024 02:00:00 AM,0,,,0,0
01/15/2024 03:00:00 AM,0,,,0,0
01/15/2024 04:00:00 AM,2,,,1,1
01/15/2024 05:00:00 AM,0,,,0,0
01/15/2024 06:00:00 AM,1,,,0,1
01/15/2024 07:00:00 AM,1,,,0,1
01/15/2024 08:00:00 AM,3,,,1,2
01/15/2024 09:00:00 AM,8,,,4,4
01/15/2024 10:00:00 AM,20,,,10,10
01/15/2024 11:00:00 AM,22,,,11,11
01/15/2024 12:00:00 PM,32,,,16,16
01/15/2024 01:00:00 PM,32,,,16,16
01/15/2024 02:00:00 PM,41,,,20,21
01/15/2024 03:00:00 PM,26,,,13,13
01/15/2024 04:00:00 PM,18,,,9,9
01/15/2024 05:00:00 PM,6,,,3,3
01/15/2024 06:00:00 PM,0,,,0,0
01/15/2024 07:00:00 PM,1,,,0,1
01/15/2024 08:00:00 PM,1,,,0,1
01/15/2024 09:00:00 PM,1,,,0,1
01/15/2024 10:00:00 PM,0,,,0,0
01/15/2024 11:00:00 PM,0,,,0,0
01/16/2024 12:00:00 AM,0,,,0,0
01/16/2024 01:00:00 AM,0,,,0,0
01/16/2024 02:00:00 AM,0,,,0,0
01/16/2024 03:00:00 AM,0,,,0,0
01/16/2024 04:00:00 AM,0,,,0,0
01/16/2024 05:00:00 AM,1,,,0,1
01/16/2024 06:00:00 AM,8,,,4,4
01/16/2024 07:00:00 AM,7,,,3,4
01/16/2024 08:00:00 AM,12,,,6,6
01/16/2024 09:00:00 AM,18,,,9,9
01/16/2024 10:00:00 AM,9,,,4,5
01/16/2024 11:00:00 AM,2,,,1,1
01/16/2024 12:00:00 PM,10,,,5,5
01/16/2024 01:00:00 PM,13,,,6,7
01/16/2024 02:00:00 PM,14,,,7,7
01/16/2024 03:00:00 PM,19,,,9,10
01/16/2024 04:00:00 PM,29,,,14,15
01/16/2024 05:00:00 PM,11,,,5,6
01/16/2024 06:00:00 PM,16,,,8,8
01/16/2024 07:00:00 PM,3,,,1,2
01/16/2024 08:00:00 PM,0,,,0,0
01/16/2024 09:00:00 PM,0,,,0,0
01/16/2024 10:00:00 PM,0,,,0,0
01/16/2024 11:00:00 PM,0,,,0,0
01/17/2024 12:00:00 AM,0,,,0,0
01/17/2024 01:00:00 AM,0,,,0,0
01/17/2024 02:00:00 AM,0,,,0,0
01/17/2024 03:00:00 AM,0,,,0,0
01/17/2024 04:00:00 AM,0,,,0,0
01/17/2024 05:00:00 AM,1,,,0,1
01/17/2024 06:00:00 AM,2,,,1,1
01/17/2024 07:00:00 AM,2,,,1,1
01/17/2024 08:00:00 AM,9,,,4,5
01/17/2024 09:00:00 AM,3,,,1,2
01/17/2024 10:00:00 AM,4,,,2,2
01/17/2024 11:00:00 AM,2,,,1,1
01/17/2024 12:00:00 PM,3,,,1,2
01/17/2024 01:00:00 PM,2,,,1,1
01/17/2024 02:00:00 PM,5,,,2,3
01/17/2024 03:00:00 PM,4,,,2,2
01/17/2024 04:00:00 PM,8,,,4,4
01/17/2024 05:00:00 PM,4,,,2,2
01/17/2024 06:00:00 PM,4,,,2,2
01/17/2024 07:00:00 PM,4,,,2,2
01/17/2024 08:00:00 PM,1,,,0,1
01/17/2024 09:00:00 PM,0,,,0,0
01/17/2024 10:00:00 PM,0,,,0,0
01/17/2024 11:00:00 PM,0,,,0,0
01/18/2024 12:00:00 AM,0,,,0,0
01/18/2024 01:00:00 AM,0,,,0,0
01/18/2024 02:00:00 AM,0,,,0,0
01/18/2024 03:00:00 AM,0,,,0,0
01/18/2024 04:00:00 AM,1,,,0,1
01/18/2024 05:00:00 AM,0,,,0,0
01/18/2024 06:00:00 AM,3,,,1,2
01/18/2024 07:00:00 AM,5,,,2,3
01/18/2024 08:00:00 AM,12,,,6,6
01/18/2024 09:00:00 AM,6,,,3,3
01/18/2024 10:00:00 AM,3,,,1,2
01/18/2024 11:00:00 AM,3,,,1,2
01/18/2024 12:00:00 PM,5,,,2,3
01/18/2024 01:00:00 PM,1,,,0,1
01/18/2024 02:00:00 PM,0,,,0,0
01/18/2024 03:00:00 PM,6,,,3,3
01/18/2024 04:00:00 PM,9,,,4,5
01/18/2024 05:00:00 PM,12,,,6,6
01/18/2024 06:00:00 PM,6,,,3,3
01/18/2024 07:00:00 PM,3,,,1,2
01/18/2024 08:00:00 PM,1,,,0,1
01/18/2024 09:00:00 PM,0,,,0,0
01/18/2024 10:00:00 PM,1,,,0,1
01/18/2024 11:00:00 PM,0,,,0,0
01/19/2024 12:00:00 AM,0,,,0,0
01/19/2024 01:00:00 AM,0,,,0,0
01/19/2024 02:00:00 AM,0,,,0,0
01/19/2024 03:00:00 AM,0,,,0,0
01/19/2024 04:00:00 AM,1,,,0,1
01/19/2024 05:00:00 AM,2,,,1,1
01/19/2024 06:00:00 AM,8,,,4,4
01/19/2024 07:00:00 AM,11,,,5,6
01/19/2024 08:00:00 AM,30,,,15,15
01/19/2024 09:00:00 AM,16,,,8,8
01/19/2024 10:00:00 AM,20,,,10,10
01/19/2024 11:00:00 AM,32,,,16,16
01/19/2024 12:00:00 PM,12,,,6,6
01/19/2024 01:00:00 PM,14,,,7,7
01/19/2024 02:00:00 PM,17,,,8,9
01/19/2024 03:00:00 PM,23,,,11,12
01/19/2024 04:00:00 PM,40,,,20,20
01/19/2024 05:00:00 PM,26,,,13,13
01/19/2024 06:00:00 PM,17,,,8,9
01/19/2024 07:00:00 PM,4,,,2,2
01/19/2024 08:00:00 PM,5,,,2,3
01/19/2024 09:00:00 PM,2,,,1,1
01/19/2024 10:00:00 PM,3,,,1,2
01/19/2024 11:00:00 PM,1,,,0,1
01/20/2024 12:00:00 AM,0,,,0,0
01/20/2024 01:00:00 AM,0,,,0,0
01/20/2024 02:00:00 AM,0,,,0,0
01/20/2024 03:00:00 AM,0,,,0,0
01/20/2024 04:00:00 AM,0,,,0,0
01/20/2024 05:00:00 AM,0,,,0,0
01/20/2024 06:00:00 AM,2,,,1,1
01/20/2024 07:00:00 AM,6,,,3,3
01/20/2024 08:00:00 AM,15,,,7,8
01/20/2024 09:00:00 AM,59,,,29,30
01/20/2024 10:00:00 AM,42,,,21,21
01/20/2024 11:00:00 AM,75,,,37,38
01/20/2024 12:00:00 PM,133,,,66,67
01/20/2024 01:00:00 PM,132,,,66,66
01/20/2024 02:00:00 PM,126,,,63,63
01/20/2024 03:00:00 PM,123,,,61,62
01/20/2024 04:00:00 PM,65,,,32,33
01/20/2024 05:00:00 PM,14,,,7,7
01/20/2024 06:00:00 PM,10,,,5,5
01/20/2024 07:00:00 PM,2,,,1,1
01/20/2024 08:00:00 PM,0,,,0,0
01/20/2024 09:00:00 PM,0,,,0,0
01/20/2024 10:00:00 PM,0,,,0,0
01/20/2024 11:00:00 PM,0,,,0,0
01/21/2024 12:00:00 AM,1,,,0,1
01/21/2024 01:00:00 AM,0,,,0,0
01/21/2024 02:00:00 AM,0,,,0,0
01/21/2024 03:00:00 AM,0,,,0,0
01/21/2024 04:00:00 AM,0,,,0,0
01/21/2024 05:00:00 AM,0,,,0,0
01/21/2024 06:00:00 AM,1,,,0,1
01/21/2024 07:00:00 AM,1,,,0,1
01/21/2024 08:00:00 AM,10,,,5,5
01/21/2024 09:00:00 AM,22,,,11,11
01/21/2024 10:00:00 AM,22,,,11,11
01/21/2024 11:00:00 AM,13,,,6,7
01/21/2024 12:00:00 PM,14,,,7,7
01/21/2024 01:00:00 PM,13,,,6,7
01/21/2024 02:00:00 PM,14,,,7,7
01/21/2024 03:00:00 PM,9,,,4,5
01/21/2024 04:00:00 PM,15,,,7,8
01/21/2024 05:00:00 PM,11,,,5,6
01/21/2024 06:00:00 PM,3,,,1,2
01/21/2024 07:00:00 PM,2,,,1,1
01/21/2024 08:00:00 PM,1,,,0,1
01/21/2024 09:00:00 PM,0,,,0,0
01/21/2024 10:00:00 PM,0,,,0,0
01/21/2024 11:00:00 PM,1,,,0,1
01/22/2024 12:00:00 AM,0,,,0,0
01/22/2024 01:00:00 AM,0,,,0,0
01/22/2024 02:00:00 AM,0,,,0,0
01/22/2024 03:00:00 AM,1,,,0,1
01/22/2024 04:00:00 AM,1,,,0,1
01/22/2024 05:00:00 AM,6,,,3,3
01/22/2024 06:00:00 AM,7,,,3,4
01/22/2024 07:00:00 AM,13,,,6,7
01/22/2024 08:00:00 AM,32,,,16,16
01/22/2024 09:00:00 AM,14,,,7,7
01/22/2024 10:00:00 AM,8,,,4,4
01/22/2024 11:00:00 AM,4,,,2,2
01/22/2024 12:00:00 PM,4,,,2,2
01/22/2024 01:00:00 PM,3,,,1,2
01/22/2024 02:00:00 PM,8,,,4,4
01/22/2024 03:00:00 PM,13,,,6,7
01/22/2024 04:00:00 PM,32,,,16,16
01/22/2024 05:00:00 PM,31,,,15,16
01/22/2024 06:00:00 PM,17,,,8,9
01/22/2024 07:00:00 PM,10,,,5,5
01/22/2024 08:00:00 PM,0,,,0,0
01/22/2024 09:00:00 PM,3,,,1,2
01/22/2024 10:00:00 PM,0,,,0,0
01/22/2024 11:00:00 PM,1,,,0,1
01/23/2024 12:00:00 AM,0,,,0,0
01/23/2024 01:00:00 AM,0,,,0,0
01/23/2024 02:00:00 AM,0,,,0,0
01/23/2024 03:00:00 AM,0,,,0,0
01/23/2024 04:00:00 AM,2,,,1,1
01/23/2024 05:00:00 AM,8,,,4,4
01/23/2024 06:00:00 AM,15,,,7,8
01/23/2024 07:00:00 AM,25,,,12,13
01/23/2024 08:00:00 AM,42,,,21,21
01/23/2024 09:00:00 AM,42,,,21,21
01/23/2024 10:00:00 AM,26,,,13,13
01/23/2024 11:00:00 AM,35,,,17,18
01/23/2024 12:00:00 PM,40,,,20,20
01/23/2024 01:00:00 PM,46,,,23,23
01/23/2024 02:00:00 PM,58,,,29,29
01/23/2024 03:00:00 PM,67,,,33,34
01/23/2024 04:00:00 PM,67,,,33,34
01/23/2024 05:00:00 PM,51,,,25,26
01/23/2024 06:00:00 PM,37,,,18,19
01/23/2024 07:00:00 PM,11,,,5,6
01/23/2024 08:00:00 PM,7,,,3,4
01/23/2024 09:00:00 PM,3,,,1,2
01/23/2024 10:00:00 PM,2,,,1,1
01/23/2024 11:00:00 PM,1,,,0,1
01/24/2024 12:00:00 AM,0,,,0,0
01/24/2024 01:00:00 AM,0,,,0,0
01/24/2024 02:00:00 AM,0,,,0,0
01/24/2024 03:00:00 AM,0,,,0,0
01/24/2024 04:00:00 AM,1,,,0,1
01/24/2024 05:00:00 AM,4,,,2,2
01/24/2024 06:00:00 AM,8,,,4,4
01/24/2024 07:00:00 AM,4,,,2,2
01/24/2024 08:00:00 AM,19,,,9,10
01/24/2024 09:00:00 AM,17,,,8,9
01/24/2024 10:00:00 AM,18,,,9,9
01/24/2024 11:00:00 AM,11,,,5,6
01/24/2024 12:00:00 PM,12,,,6,6
01/24/2024 01:00:00 PM,15,,,7,8
01/24/2024 02:00:00 PM,11,,,5,6
01/24/2024 03:00:00 PM,16,,,8,8
01/24/2024 04:00:00 PM,22,,,11,11
01/24/2024 05:00:00 PM,35,,,17,18
01/24/2024 06:00:00 PM,8,,,4,4
01/24/2024 07:00:00 PM,6,,,3,3
01/24/2024 08:00:00 PM,4,,,2,2
01/24/2024 09:00:00 PM,0,,,0,0
01/24/2024 10:00:00 PM,0,,,0,0
01/24/2024 11:00:00 PM,1,,,0,1
01/25/2024 12:00:00 AM,0,,,0,0
01/25/2024 01:00:00 AM,1,,,0,1
01/25/2024 02:00:00 AM,0,,,0,0
01/25/2024 03:00:00 AM,0,,,0,0
01/25/2024 04:00:00 AM,2,,,1,1
01/25/2024 05:00:00 AM,4,,,2,2
01/25/2024 06:00:00 AM,10,,,5,5
01/25/2024 07:00:00 AM,13,,,6,7
01/25/2024 08:00:00 AM,35,,,17,18
01/25/2024 09:00:00 AM,17,,,8,9
01/25/2024 10:00:00 AM,16,,,8,8
01/25/2024 11:00:00 AM,18,,,9,9
01/25/2024 12:00:00 PM,19,,,9,10
01/25/2024 01:00:00 PM,20,,,10,10
01/25/2024 02:00:00 PM,24,,,12,12
01/25/2024 03:00:00 PM,26,,,13,13
01/25/2024 04:00:00 PM,34,,,17,17
01/25/2024 05:00:00 PM,35,,,17,18
01/25/2024 06:00:00 PM,22,,,11,11
01/25/2024 07:00:00 PM,14,,,7,7
01/25/2024 08:00:00 PM,2,,,1,1
01/25/2024 09:00:00 PM,4,,,2,2
01/25/2024 10:00:00 PM,1,,,0,1
01/25/2024 11:00:00 PM,1,,,0,1
01/26/2024 12:00:00 AM,0,,,0,0
01/26/2024 01:00:00 AM,1,,,0,1
01/26/2024 02:00:00 AM,0,,,0,0
01/26/2024 03:00:00 AM,0,,,0,0
01/26/2024 04:00:00 AM,0,,,0,0
01/26/2024 05:00:00 AM,7,,,3,4
01/26/2024 06:00:00 AM,10,,,5,5
01/26/2024 07:00:00 AM,19,,,9,10
01/26/2024 08:00:00 AM,33,,,16,17
01/26/2024 09:00:00 AM,24,,,12,12
01/26/2024 10:00:00 AM,25,,,12,13
01/26/2024 11:00:00 AM,35,,,17,18
01/26/2024 12:00:00 PM,29,,,14,15
01/26/2024 01:00:00 PM,37,,,18,19
01/26/2024 02:00:00 PM,44,,,22,22
01/26/2024 03:00:00 PM,33,,,16,17
01/26/2024 04:00:00 PM,34,,,17,17
01/26/2024 05:00:00 PM,23,,,11,12
01/26/2024 06:00:00 PM,16,,,8,8
01/26/2024 07:00:00 PM,8,,,4,4
01/26/2024 08:00:00 PM,0,,,0,0
01/26/2024 09:00:00 PM,3,,,1,2
01/26/2024 10:00:00 PM,0,,,0,0
01/26/2024 11:00:00 PM,0,,,0,0
01/27/2024 12:00:00 AM,2,,,1,1
01/27/2024 01:00:00 AM,0,,,0,0
01/27/2024 02:00:00 AM,1,,,0,1
01/27/2024 03:00:00 AM,0,,,0,0
01/27/2024 04:00:00 AM,0,,,0,0
01/27/2024 05:00:00 AM,0,,,0,0
01/27/2024 06:00:00 AM,3,,,1,2
01/27/2024 07:00:00 AM,8,,,4,4
01/27/2024 08:00:00 AM,8,,,4,4
01/27/2024 09:00:00 AM,11,,,5,6
01/27/2024 10:00:00 AM,6,,,3,3
01/27/2024 11:00:00 AM,14,,,7,7
01/27/2024 12:00:00 PM,11,,,5,6
01/27/2024 01:00:00 PM,21,,,10,11
01/27/2024 02:00:00 PM,7,,,3,4
01/27/2024 03:00:00 PM,23,,,11,12
01/27/2024 04:00:00 PM,13,,,6,7
01/27/2024 05:00:00 PM,6,,,3,3
01/27/2024 06:00:00 PM,2,,,1,1
01/27/2024 07:00:00 PM,4,,,2,2
01/27/2024 08:00:00 PM,1,,,0,1
01/27/2024 09:00:00 PM,0,,,0,0
01/27/2024 10:00:00 PM,0,,,0,0
01/27/2024 11:00:00 PM,2,,,1,1
01/28/2024 12:00:00 AM,2,,,1,1
01/28/2024 01:00:00 AM,1,,,0,1
01/28/2024 02:00:00 AM,0,,,0,0
01/28/2024 03:00:00 AM,0,,,0,0
01/28/2024 04:00:00 AM,0,,,0,0
01/28/2024 05:00:00 AM,0,,,0,0
01/28/2024 06:00:00 AM,1,,,0,1
01/28/2024 07:00:00 AM,7,,,3,4
01/28/2024 08:00:00 AM,16,,,8,8
01/28/2024 09:00:00 AM,41,,,20,21
01/28/2024 10:00:00 AM,61,,,30,31
01/28/2024 11:00:00 AM,83,,,41,42
01/28/2024 12:00:00 PM,89,,,44,45
01/28/2024 01:00:00 PM,103,,,51,52
01/28/2024 02:00:00 PM,71,,,35,36
01/28/2024 03:00:00 PM,55,,,27,28
01/28/2024 04:00:00 PM,32,,,16,16
01/28/2024 05:00:00 PM,18,,,9,9
01/28/2024 06:00:00 PM,1,,,0,1
01/28/2024 07:00:00 PM,2,,,1,1
01/28/2024 08:00:00 PM,3,,,1,2
01/28/2024 09:00:00 PM,0,,,0,0
01/28/2024 10:00:00 PM,0,,,0,0
01/28/2024 11:00:00 PM,1,,,0,1
01/29/2024 12:00:00 AM,4,,,2,2
01/29/2024 01:00:00 AM,0,,,0,0
01/29/2024 02:00:00 AM,0,,,0,0
01/29/2024 03:00:00 AM,0,,,0,0
01/29/2024 04:00:00 AM,0,,,0,0
01/29/2024 05:00:00 AM,5,,,2,3
01/29/2024 06:00:00 AM,14,,,7,7
01/29/2024 07:00:00 AM,36,,,18,18
01/29/2024 08:00:00 AM,41,,,20,21
01/29/2024 09:00:00 AM,35,,,17,18
01/29/2024 10:00:00 AM,43,,,21,22
01/29/2024 11:00:00 AM,35,,,17,18
01/29/2024 12:00:00 PM,45,,,22,23
01/29/2024 01:00:00 PM,46,,,23,23
01/29/2024 02:00:00 PM,73,,,36,37
01/29/2024 03:00:00 PM,74,,,37,37
01/29/2024 04:00:00 PM,89,,,44,45
01/29/2024 05:00:00 PM,52,,,26,26
01/29/2024 06:00:00 PM,42,,,21,21
01/29/2024 07:00:00 PM,11,,,5,6
01/29/2024 08:00:00 PM,2,,,1,1
01/29/2024 09:00:00 PM,2,,,1,1
01/29/2024 10:00:00 PM,1,,,0,1
01/29/2024 11:00:00 PM,1,,,0,1
01/30/2024 12:00:00 AM,0,,,0,0
01/30/2024 01:00:00 AM,0,,,0,0
01/30/2024 02:00:00 AM,0,,,0,0
01/30/2024 03:00:00 AM,1,,,0,1
01/30/2024 04:00:00 AM,1,,,0,1
01/30/2024 05:00:00 AM,9,,,4,5
01/30/2024 06:00:00 AM,15,,,7,8
01/30/2024 07:00:00 AM,30,,,15,15
01/30/2024 08:00:00 AM,57,,,28,29
01/30/2024 09:00:00 AM,26,,,13,13
01/30/2024 10:00:00 AM,28,,,14,14
01/30/2024 11:00:00 AM,18,,,9,9
01/30/2024 12:00:00 PM,15,,,7,8
01/30/2024 01:00:00 PM,20,,,10,10
01/30/2024 02:00:00 PM,35,,,17,18
01/30/2024 03:00:00 PM,43,,,21,22
01/30/2024 04:00:00 PM,75,,,37,38
01/30/2024 05:00:00 PM,50,,,25,25
01/30/2024 06:00:00 PM,29,,,14,15
01/30/2024 07:00:00 PM,10,,,5,5
01/30/2024 08:00:00 PM,4,,,2,2
01/30/2024 09:00:00 PM,2,,,1,1
01/30/2024 10:00:00 PM,1,,,0,1
01/30/2024 11:00:00 PM,2,,,1,1
01/31/2024 12:00:00 AM,0,,,0,0
01/31/2024 01:00:00 AM,0,,,0,0
01/31/2024 02:00:00 AM,0,,,0,0
01/31/2024 03:00:00 AM,2,,,1,1
01/31/2024 04:00:00 AM,1,,,0,1
01/31/2024 05:00:00 AM,5,,,2,3
01/31/2024 06:00:00 AM,6,,,3,3
01/31/2024 07:00:00 AM,14,,,7,7
01/31/2024 08:00:00 AM,25,,,12,13
01/31/2024 09:00:00 AM,16,,,8,8
01/31/2024 10:00:00 AM,13,,,6,7
01/31/2024 11:00:00 AM,12,,,6,6
01/31/2024 12:00:00 PM,10,,,5,5
01/31/2024 01:00:00 PM,12,,,6,6
01/31/2024 02:00:00 PM,14,,,7,7
01/31/2024 03:00:00 PM,10,,,5,5
01/31/2024 04:00:00 PM,27,,,13,14
01/31/2024 05:00:00 PM,26,,,13,13
01/31/2024 06:00:00 PM,12,,,6,6
01/31/2024 07:00:00 PM,6,,,3,3
01/31/2024 08:00:00 PM,1,,,0,1
01/31/2024 09:00:00 PM,3,,,1,2
01/31/2024 10:00:00 PM,1,,,0,1
01/31/2024 11:00:00 PM,0,,,0,0
02/01/2024 12:00:00 AM,0,,,0,0
02/01/2024 01:00:00 AM,0,,,0,0
02/01/2024 02:00:00 AM,0,,,0,0
02/01/2024 03:00:00 AM,0,,,0,0
02/01/2024 04:00:00 AM,0,,,0,0
02/01/2024 05:00:00 AM,5,,,2,3
02/01/2024 06:00:00 AM,11,,,5,6
02/01/2024 07:00:00 AM,19,,,9,10
02/01/2024 08:00:00 AM,36,,,18,18
02/01/2024 09:00:00 AM,24,,,12,12
02/01/2024 10:00:00 AM,25,,,12,13
02/01/2024 11:00:00 AM,20,,,10,10
02/01/2024 12:00:00 PM,22,,,11,11
02/01/2024 01:00:00 PM,20,,,10,10
02/01/2024 02:00:00 PM,39,,,19,20
02/01/2024 03:00:00 PM,57,,,28,29
02/01/2024 04:00:00 PM,88,,,44,44
02/01/2024 05:00:00 PM,53,,,26,27
02/01/2024 06:00:00 PM,22,,,11,11
02/01/2024 07:00:00 PM,14,,,7,7
02/01/2024 08:00:00 PM,7,,,3,4
02/01/2024 09:00:00 PM,2,,,1,1
02/01/2024 10:00:00 PM,0,,,0,0
02/01/2024 11:00:00 PM,0,,,0,0
02/02/2024 12:00:00 AM,1,,,0,1
02/02/2024 01:00:00 AM,0,,,0,0
02/02/2024 02:00:00 AM,0,,,0,0
02/02/2024 03:00:00 AM,0,,,0,0
02/02/2024 04:00:00 AM,0,,,0,0
02/02/2024 05:00:00 AM,4,,,2,2
02/02/2024 06:00:00 AM,12,,,6,6
02/02/2024 07:00:00 AM,24,,,12,12
02/02/2024 08:00:00 AM,30,,,15,15
02/02/2024 09:00:00 AM,24,,,12,12
02/02/2024 10:00:00 AM,43,,,21,22
02/02/2024 11:00:00 AM,43,,,21,22
02/02/2024 12:00:00 PM,46,,,23,23
02/02/2024 01:00:00 PM,32,,,16,16
02/02/2024 02:00:00 PM,69,,,34,35
02/02/2024 03:00:00 PM,78,,,39,39
02/02/2024 04:00:00 PM,86,,,43,43
02/02/2024 05:00:00 PM,42,,,21,21
02/02/2024 06:00:00 PM,20,,,10,10
02/02/2024 07:00:00 PM,8,,,4,4
02/02/2024 08:00:00 PM,1,,,0,1
02/02/2024 09:00:00 PM,5,,,2,3
02/02/2024 10:00:00 PM,1,,,0,1
02/02/2024 11:00:00 PM,0,,,0,0
02/03/2024 12:00:00 AM,0,,,0,0
02/03/2024 01:00:00 AM,1,,,0,1
02/03/2024 02:00:00 AM,0,,,0,0
02/03/2024 03:00:00 AM,2,,,1,1
02/03/2024 04:00:00 AM,0,,,0,0
02/03/2024 05:00:00 AM,2,,,1,1
02/03/2024 06:00:00 AM,0,,,0,0
02/03/2024 07:00:00 AM,12,,,6,6
02/03/2024 08:00:00 AM,43,,,21,22
02/03/2024 09:00:00 AM,77,,,38,39
02/03/2024 10:00:00 AM,99,,,49,50
02/03/2024 11:00:00 AM,101,,,50,51
02/03/2024 12:00:00 PM,140,,,70,70
02/03/2024 01:00:00 PM,139,,,69,70
02/03/2024 02:00:00 PM,136,,,68,68
02/03/2024 03:00:00 PM,140,,,70,70
02/03/2024 04:00:00 PM,87,,,43,44
02/03/2024 05:00:00 PM,38,,,19,19
02/03/2024 06:00:00 PM,10,,,5,5
02/03/2024 07:00:00 PM,8,,,4,4
02/03/2024 08:00:00 PM,3,,,1,2
02/03/2024 09:00:00 PM,2,,,1,1
02/03/2024 10:00:00 PM,0,,,0,0
02/03/2024 11:00:00 PM,1,,,0,1
02/04/2024 12:00:00 AM,1,,,0,1
02/04/2024 01:00:00 AM,0,,,0,0
02/04/2024 02:00:00 AM,0,,,0,0
02/04/2024 03:00:00 AM,2,,,1,1
02/04/2024 04:00:00 AM,1,,,0,1
02/04/2024 05:00:00 AM,1,,,0,1
02/04/2024 06:00:00 AM,2,,,1,1
02/04/2024 07:00:00 AM,13,,,6,7
02/04/2024 08:00:00 AM,25,,,12,13
02/04/2024 09:00:00 AM,30,,,15,15
02/04/2024 10:00:00 AM,75,,,37,38
02/04/2024 11:00:00 AM,96,,,48,48
02/04/2024 12:00:00 PM,121,,,60,61
02/04/2024 01:00:00 PM,127,,,63,64
02/04/2024 02:00:00 PM,144,,,72,72
02/04/2024 03:00:00 PM,120,,,60,60
02/04/2024 04:00:00 PM,67,,,33,34
02/04/2024 05:00:00 PM,22,,,11,11
02/04/2024 06:00:00 PM,14,,,7,7
02/04/2024 07:00:00 PM,3,,,1,2
02/04/2024 08:00:00 PM,1,,,0,1
02/04/2024 09:00:00 PM,1,,,0,1
02/04/2024 10:00:00 PM,0,,,0,0
02/04/2024 11:00:00 PM,1,,,0,1
02/05/2024 12:00:00 AM,0,,,0,0
02/05/2024 01:00:00 AM,0,,,0,0
02/05/2024 02:00:00 AM,0,,,0,0
02/05/2024 03:00:00 AM,0,,,0,0
02/05/2024 04:00:00 AM,4,,,2,2
02/05/2024 05:00:00 AM,4,,,2,2
02/05/2024 06:00:00 AM,16,,,8,8
02/05/2024 07:00:00 AM,19,,,9,10
02/05/2024 08:00:00 AM,30,,,15,15
02/05/2024 09:00:00 AM,16,,,8,8
02/05/2024 10:00:00 AM,40,,,20,20
02/05/2024 11:00:00 AM,15,,,7,8
02/05/2024 12:00:00 PM,23,,,11,12
02/05/2024 01:00:00 PM,20,,,10,10
02/05/2024 02:00:00 PM,8,,,4,4
02/05/2024 03:00:00 PM,21,,,10,11
02/05/2024 04:00:00 PM,27,,,13,14
02/05/2024 05:00:00 PM,30,,,15,15
02/05/2024 06:00:00 PM,19,,,9,10
02/05/2024 07:00:00 PM,9,,,4,5
02/05/2024 08:00:00 PM,2,,,1,1
02/05/2024 09:00:00 PM,1,,,0,1
02/05/2024 10:00:00 PM,0,,,0,0
02/05/2024 11:00:00 PM,2,,,1,1
02/06/2024 12:00:00 AM,0,,,0,0
02/06/2024 01:00:00 AM,0,,,0,0
02/06/2024 02:00:00 AM,0,,,0,0
02/06/2024 03:00:00 AM,0,,,0,0
02/06/2024 04:00:00 AM,3,,,1,2
02/06/2024 05:00:00 AM,7,,,3,4
02/06/2024 06:00:00 AM,8,,,4,4
02/06/2024 07:00:00 AM,17,,,8,9
02/06/2024 08:00:00 AM,38,,,19,19
02/06/2024 09:00:00 AM,20,,,10,10
02/06/2024 10:00:00 AM,14,,,7,7
02/06/2024 11:00:00 AM,22,,,11,11
02/06/2024 12:00:00 PM,9,,,4,5
02/06/2024 01:00:00 PM,26,,,13,13
02/06/2024 02:00:00 PM,19,,,9,10
02/06/2024 03:00:00 PM,21,,,10,11
02/06/2024 04:00:00 PM,47,,,23,24
02/06/2024 05:00:00 PM,46,,,23,23
02/06/2024 06:00:00 PM,27,,,13,14
02/06/2024 07:00:00 PM,9,,,4,5
02/06/2024 08:00:00 PM,10,,,5,5
02/06/2024 09:00:00 PM,0,,,0,0
02/06/2024 10:00:00 PM,1,,,0,1
02/06/2024 11:00:00 PM,2,,,1,1
02/07/2024 12:00:00 AM,0,,,0,0
02/07/2024 01:00:00 AM,0,,,0,0
02/07/2024 02:00:00 AM,0,,,0,0
02/07/2024 03:00:00 AM,0,,,0,0
02/07/2024 04:00:00 AM,1,,,0,1
02/07/2024 05:00:00 AM,8,,,4,4
02/07/2024 06:00:00 AM,13,,,6,7
02/07/2024 07:00:00 AM,20,,,10,10
02/07/2024 08:00:00 AM,44,,,22,22
02/07/2024 09:00:00 AM,16,,,8,8
02/07/2024 10:00:00 AM,19,,,9,10
02/07/2024 11:00:00 AM,30,,,15,15
02/07/2024 12:00:00 PM,44,,,22,22
02/07/2024 01:00:00 PM,46,,,23,23
02/07/2024 02:00:00 PM,55,,,27,28
02/07/2024 03:00:00 PM,55,,,27,28
02/07/2024 04:00:00 PM,58,,,29,29
02/07/2024 05:00:00 PM,62,,,31,31
02/07/2024 06:00:00 PM,22,,,11,11
02/07/2024 07:00:00 PM,6,,,3,3
02/07/2024 08:00:00 PM,3,,,1,2
02/07/2024 09:00:00 PM,3,,,1,2
02/07/2024 10:00:00 PM,3,,,1,2
02/07/2024 11:00:00 PM,0,,,0,0
02/08/2024 12:00:00 AM,0,,,0,0
02/08/2024 01:00:00 AM,0,,,0,0
02/08/2024 02:00:00 AM,0,,,0,0
02/08/2024 03:00:00 AM,0,,,0,0
02/08/2024 04:00:00 AM,1,,,0,1
02/08/2024 05:00:00 AM,6,,,3,3
02/08/2024 06:00:00 AM,15,,,7,8
02/08/2024 07:00:00 AM,18,,,9,9
02/08/2024 08:00:00 AM,42,,,21,21
02/08/2024 09:00:00 AM,31,,,15,16
02/08/2024 10:00:00 AM,26,,,13,13
02/08/2024 11:00:00 AM,23,,,11,12
02/08/2024 12:00:00 PM,18,,,9,9
02/08/2024 01:00:00 PM,27,,,13,14
02/08/2024 02:00:00 PM,21,,,10,11
02/08/2024 03:00:00 PM,36,,,18,18
02/08/2024 04:00:00 PM,47,,,23,24
02/08/2024 05:00:00 PM,41,,,20,21
02/08/2024 06:00:00 PM,17,,,8,9
02/08/2024 07:00:00 PM,9,,,4,5
02/08/2024 08:00:00 PM,6,,,3,3
02/08/2024 09:00:00 PM,3,,,1,2
02/08/2024 10:00:00 PM,0,,,0,0
02/08/2024 11:00:00 PM,0,,,0,0
02/09/2024 12:00:00 AM,0,,,0,0
02/09/2024 01:00:00 AM,0,,,0,0
02/09/2024 02:00:00 AM,0,,,0,0
02/09/2024 03:00:00 AM,0,,,0,0
02/09/2024 04:00:00 AM,0,,,0,0
02/09/2024 05:00:00 AM,6,,,3,3
02/09/2024 06:00:00 AM,11,,,5,6
02/09/2024 07:00:00 AM,7,,,3,4
02/09/2024 08:00:00 AM,20,,,10,10
02/09/2024 09:00:00 AM,22,,,11,11
02/09/2024 10:00:00 AM,16,,,8,8
02/09/2024 11:00:00 AM,20,,,10,10
02/09/2024 12:00:00 PM,25,,,12,13
02/09/2024 01:00:00 PM,26,,,13,13
02/09/2024 02:00:00 PM,47,,,23,24
02/09/2024 03:00:00 PM,39,,,19,20
02/09/2024 04:00:00 PM,57,,,28,29
02/09/2024 05:00:00 PM,35,,,17,18
02/09/2024 06:00:00 PM,25,,,12,13
02/09/2024 07:00:00 PM,7,,,3,4
02/09/2024 08:00:00 PM,5,,,2,3
02/09/2024 09:00:00 PM,2,,,1,1
02/09/2024 10:00:00 PM,1,,,0,1
02/09/2024 11:00:00 PM,1,,,0,1
02/10/2024 12:00:00 AM,2,,,1,1
02/10/2024 01:00:00 AM,0,,,0,0
02/10/2024 02:00:00 AM,0,,,0,0
02/10/2024 03:00:00 AM,0,,,0,0
02/10/2024 04:00:00 AM,0,,,0,0
02/10/2024 05:00:00 AM,0,,,0,0
02/10/2024 06:00:00 AM,1,,,0,1
02/10/2024 07:00:00 AM,4,,,2,2
02/10/2024 08:00:00 AM,41,,,20,21
02/10/2024 09:00:00 AM,75,,,37,38
02/10/2024 10:00:00 AM,106,,,53,53
02/10/2024 11:00:00 AM,109,,,54,55
02/10/2024 12:00:00 PM,139,,,69,70
02/10/2024 01:00:00 PM,139,,,69,70
02/10/2024 02:00:00 PM,183,,,91,92
02/10/2024 03:00:00 PM,126,,,63,63
02/10/2024 04:00:00 PM,74,,,37,37
02/10/2024 05:00:00 PM,38,,,19,19
02/10/2024 06:00:00 PM,11,,,5,6
02/10/2024 07:00:00 PM,6,,,3,3
02/10/2024 08:00:00 PM,5,,,2,3
02/10/2024 09:00:00 PM,0,,,0,0
02/10/2024 10:00:00 PM,1,,,0,1
02/10/2024 11:00:00 PM,1,,,0,1
02/11/2024 12:00:00 AM,0,,,0,0
02/11/2024 01:00:00 AM,0,,,0,0
02/11/2024 02:00:00 AM,0,,,0,0
02/11/2024 03:00:00 AM,0,,,0,0
02/11/2024 04:00:00 AM,0,,,0,0
02/11/2024 05:00:00 AM,0,,,0,0
02/11/2024 06:00:00 AM,0,,,0,0
02/11/2024 07:00:00 AM,2,,,1,1
02/11/2024 08:00:00 AM,7,,,3,4
02/11/2024 09:00:00 AM,19,,,9,10
02/11/2024 10:00:00 AM,14,,,7,7
02/11/2024 11:00:00 AM,14,,,7,7
02/11/2024 12:00:00 PM,17,,,8,9
02/11/2024 01:00:00 PM,26,,,13,13
02/11/2024 02:00:00 PM,41,,,20,21
02/11/2024 03:00:00 PM,27,,,13,14
02/11/2024 04:00:00 PM,18,,,9,9
02/11/2024 05:00:00 PM,9,,,4,5
02/11/2024 06:00:00 PM,2,,,1,1
02/11/2024 07:00:00 PM,0,,,0,0
02/11/2024 08:00:00 PM,1,,,0,1
02/11/2024 09:00:00 PM,1,,,0,1
02/11/2024 10:00:00 PM,0,,,0,0
02/11/2024 11:00:00 PM,1,,,0,1
02/12/2024 12:00:00 AM,0,,,0,0
02/12/2024 01:00:00 AM,0,,,0,0
02/12/2024 02:00:00 AM,0,,,0,0
02/12/2024 03:00:00 AM,0,,,0,0
02/12/2024 04:00:00 AM,0,,,0,0
02/12/2024 05:00:00 AM,3,,,1,2
02/12/2024 06:00:00 AM,9,,,4,5
02/12/2024 07:00:00 AM,22,,,11,11
02/12/2024 08:00:00 AM,31,,,15,16
02/12/2024 09:00:00 AM,9,,,4,5
02/12/2024 10:00:00 AM,13,,,6,7
02/12/2024 11:00:00 AM,11,,,5,6
02/12/2024 12:00:00 PM,13,,,6,7
02/12/2024 01:00:00 PM,11,,,5,6
02/12/2024 02:00:00 PM,11,,,5,6
02/12/2024 03:00:00 PM,35,,,17,18
02/12/2024 04:00:00 PM,37,,,18,19
02/12/2024 05:00:00 PM,58,,,29,29
02/12/2024 06:00:00 PM,16,,,8,8
02/12/2024 07:00:00 PM,9,,,4,5
02/12/2024 08:00:00 PM,2,,,1,1
02/12/2024 09:00:00 PM,4,,,2,2
02/12/2024 10:00:00 PM,1,,,0,1
02/12/2024 11:00:00 PM,1,,,0,1
02/13/2024 12:00:00 AM,0,,,0,0
02/13/2024 01:00:00 AM,0,,,0,0
02/13/2024 02:00:00 AM,0,,,0,0
02/13/2024 03:00:00 AM,0,,,0,0
02/13/2024 04:00:00 AM,0,,,0,0
02/13/2024 05:00:00 AM,4,,,2,2
02/13/2024 06:00:00 AM,13,,,6,7
02/13/2024 07:00:00 AM,23,,,11,12
02/13/2024 08:00:00 AM,42,,,21,21
02/13/2024 09:00:00 AM,28,,,14,14
02/13/2024 10:00:00 AM,22,,,11,11
02/13/2024 11:00:00 AM,26,,,13,13
02/13/2024 12:00:00 PM,34,,,17,17
02/13/2024 01:00:00 PM,37,,,18,19
02/13/2024 02:00:00 PM,35,,,17,18
02/13/2024 03:00:00 PM,44,,,22,22
02/13/2024 04:00:00 PM,61,,,30,31
02/13/2024 05:00:00 PM,66,,,33,33
02/13/2024 06:00:00 PM,28,,,14,14
02/13/2024 07:00:00 PM,7,,,3,4
02/13/2024 08:00:00 PM,4,,,2,2
02/13/2024 09:00:00 PM,6,,,3,3
02/13/2024 10:00:00 PM,1,,,0,1
02/13/2024 11:00:00 PM,1,,,0,1
02/14/2024 12:00:00 AM,0,,,0,0
02/14/2024 01:00:00 AM,0,,,0,0
02/14/2024 02:00:00 AM,0,,,0,0
02/14/2024 03:00:00 AM,0,,,0,0
02/14/2024 04:00:00 AM,0,,,0,0
02/14/2024 05:00:00 AM,3,,,1,2
02/14/2024 06:00:00 AM,8,,,4,4
02/14/2024 07:00:00 AM,21,,,10,11
02/14/2024 08:00:00 AM,31,,,15,16
02/14/2024 09:00:00 AM,29,,,14,15
02/14/2024 10:00:00 AM,27,,,13,14
02/14/2024 11:00:00 AM,36,,,18,18
02/14/2024 12:00:00 PM,29,,,14,15
02/14/2024 01:00:00 PM,33,,,16,17
02/14/2024 02:00:00 PM,43,,,21,22
02/14/2024 03:00:00 PM,36,,,18,18
02/14/2024 04:00:00 PM,61,,,30,31
02/14/2024 05:00:00 PM,42,,,21,21
02/14/2024 06:00:00 PM,23,,,11,12
02/14/2024 07:00:00 PM,4,,,2,2
02/14/2024 08:00:00 PM,2,,,1,1
02/14/2024 09:00:00 PM,0,,,0,0
02/14/2024 10:00:00 PM,2,,,1,1
02/14/2024 11:00:00 PM,0,,,0,0
02/15/2024 12:00:00 AM,0,,,0,0
02/15/2024 01:00:00 AM,0,,,0,0
02/15/2024 02:00:00 AM,0,,,0,0
02/15/2024 03:00:00 AM,0,,,0,0
02/15/2024 04:00:00 AM,2,,,1,1
02/15/2024 05:00:00 AM,2,,,1,1
02/15/2024 06:00:00 AM,5,,,2,3
02/15/2024 07:00:00 AM,12,,,6,6
02/15/2024 08:00:00 AM,28,,,14,14
02/15/2024 09:00:00 AM,14,,,7,7
02/15/2024 10:00:00 AM,9,,,4,5
02/15/2024 11:00:00 AM,10,,,5,5
02/15/2024 12:00:00 PM,2,,,1,1
02/15/2024 01:00:00 PM,4,,,2,2
02/15/2024 02:00:00 PM,6,,,3,3
02/15/2024 03:00:00 PM,13,,,6,7
02/15/2024 04:00:00 PM,23,,,11,12
02/15/2024 05:00:00 PM,39,,,19,20
02/15/2024 06:00:00 PM,13,,,6,7
02/15/2024 07:00:00 PM,5,,,2,3
02/15/2024 08:00:00 PM,3,,,1,2
02/15/2024 09:00:00 PM,4,,,2,2
02/15/2024 10:00:00 PM,2,,,1,1
02/15/2024 11:00:00 PM,0,,,0,0
02/16/2024 12:00:00 AM,1,,,0,1
02/16/2024 01:00:00 AM,0,,,0,0
02/16/2024 02:00:00 AM,0,,,0,0
02/16/2024 03:00:00 AM,0,,,0,0
02/16/2024 04:00:00 AM,0,,,0,0
02/16/2024 05:00:00 AM,2,,,1,1
02/16/2024 06:00:00 AM,6,,,3,3
02/16/2024 07:00:00 AM,11,,,5,6
02/16/2024 08:00:00 AM,28,,,14,14
02/16/2024 09:00:00 AM,14,,,7,7
02/16/2024 10:00:00 AM,27,,,13,14
02/16/2024 11:00:00 AM,32,,,16,16
02/16/2024 12:00:00 PM,30,,,15,15
02/16/2024 01:00:00 PM,76,,,38,38
02/16/2024 02:00:00 PM,77,,,38,39
02/16/2024 03:00:00 PM,71,,,35,36
02/16/2024 04:00:00 PM,70,,,35,35
02/16/2024 05:00:00 PM,47,,,23,24
02/16/2024 06:00:00 PM,16,,,8,8
02/16/2024 07:00:00 PM,6,,,3,3
02/16/2024 08:00:00 PM,3,,,1,2
02/16/2024 09:00:00 PM,1,,,0,1
02/16/2024 10:00:00 PM,2,,,1,1
02/16/2024 11:00:00 PM,1,,,0,1
02/17/2024 12:00:00 AM,1,,,0,1
02/17/2024 01:00:00 AM,0,,,0,0
02/17/2024 02:00:00 AM,0,,,0,0
02/17/2024 03:00:00 AM,0,,,0,0
02/17/2024 04:00:00 AM,0,,,0,0
02/17/2024 05:00:00 AM,1,,,0,1
02/17/2024 06:00:00 AM,3,,,1,2
02/17/2024 07:00:00 AM,8,,,4,4
02/17/2024 08:00:00 AM,37,,,18,19
02/17/2024 09:00:00 AM,56,,,28,28
02/17/2024 10:00:00 AM,53,,,26,27
02/17/2024 11:00:00 AM,76,,,38,38
02/17/2024 12:00:00 PM,86,,,43,43
02/17/2024 01:00:00 PM,92,,,46,46
02/17/2024 02:00:00 PM,93,,,46,47
02/17/2024 03:00:00 PM,73,,,36,37
02/17/2024 04:00:00 PM,69,,,34,35
02/17/2024 05:00:00 PM,37,,,18,19
02/17/2024 06:00:00 PM,10,,,5,5
02/17/2024 07:00:00 PM,2,,,1,1
02/17/2024 08:00:00 PM,0,,,0,0
02/17/2024 09:00:00 PM,4,,,2,2
02/17/2024 10:00:00 PM,2,,,1,1
02/17/2024 11:00:00 PM,0,,,0,0
02/18/2024 12:00:00 AM,0,,,0,0
02/18/2024 01:00:00 AM,0,,,0,0
02/18/2024 02:00:00 AM,0,,,0,0
02/18/2024 03:00:00 AM,0,,,0,0
02/18/2024 04:00:00 AM,0,,,0,0
02/18/2024 05:00:00 AM,0,,,0,0
02/18/2024 06:00:00 AM,0,,,0,0
02/18/2024 07:00:00 AM,8,,,4,4
02/18/2024 08:00:00 AM,15,,,7,8
02/18/2024 09:00:00 AM,20,,,10,10
02/18/2024 10:00:00 AM,39,,,19,20
02/18/2024 11:00:00 AM,66,,,33,33
02/18/2024 12:00:00 PM,53,,,26,27
02/18/2024 01:00:00 PM,84,,,42,42
02/18/2024 02:00:00 PM,65,,,32,33
02/18/2024 03:00:00 PM,62,,,31,31
02/18/2024 04:00:00 PM,39,,,19,20
02/18/2024 05:00:00 PM,24,,,12,12
02/18/2024 06:00:00 PM,13,,,6,7
02/18/2024 07:00:00 PM,3,,,1,2
02/18/2024 08:00:00 PM,3,,,1,2
02/18/2024 09:00:00 PM,2,,,1,1
02/18/2024 10:00:00 PM,3,,,1,2
02/18/2024 11:00:00 PM,0,,,0,0
02/19/2024 12:00:00 AM,0,,,0,0
02/19/2024 01:00:00 AM,0,,,0,0
02/19/2024 02:00:00 AM,0,,,0,0
02/19/2024 03:00:00 AM,0,,,0,0
02/19/2024 04:00:00 AM,0,,,0,0
02/19/2024 05:00:00 AM,0,,,0,0
02/19/2024 06:00:00 AM,4,,,2,2
02/19/2024 07:00:00 AM,8,,,4,4
02/19/2024 08:00:00 AM,16,,,8,8
02/19/2024 09:00:00 AM,44,,,22,22
02/19/2024 10:00:00 AM,73,,,36,37
02/19/2024 11:00:00 AM,72,,,36,36
02/19/2024 12:00:00 PM,64,,,32,32
02/19/2024 01:00:00 PM,47,,,23,24
02/19/2024 02:00:00 PM,31,,,15,16
02/19/2024 03:00:00 PM,28,,,14,14
02/19/2024 04:00:00 PM,17,,,8,9
02/19/2024 05:00:00 PM,14,,,7,7
02/19/2024 06:00:00 PM,14,,,7,7
02/19/2024 07:00:00 PM,7,,,3,4
02/19/2024 08:00:00 PM,4,,,2,2
02/19/2024 09:00:00 PM,1,,,0,1
02/19/2024 10:00:00 PM,0,,,0,0
02/19/2024 11:00:00 PM,1,,,0,1
02/20/2024 12:00:00 AM,1,,,0,1
02/20/2024 01:00:00 AM,0,,,0,0
02/20/2024 02:00:00 AM,0,,,0,0
02/20/2024 03:00:00 AM,0,,,0,0
02/20/2024 04:00:00 AM,5,,,2,3
02/20/2024 05:00:00 AM,6,,,3,3
02/20/2024 06:00:00 AM,7,,,3,4
02/20/2024 07:00:00 AM,21,,,10,11
02/20/2024 08:00:00 AM,23,,,11,12
02/20/2024 09:00:00 AM,11,,,5,6
02/20/2024 10:00:00 AM,14,,,7,7
02/20/2024 11:00:00 AM,12,,,6,6
02/20/2024 12:00:00 PM,6,,,3,3
02/20/2024 01:00:00 PM,21,,,10,11
02/20/2024 02:00:00 PM,22,,,11,11
02/20/2024 03:00:00 PM,27,,,13,14
02/20/2024 04:00:00 PM,46,,,23,23
02/20/2024 05:00:00 PM,58,,,29,29
02/20/2024 06:00:00 PM,19,,,9,10
02/20/2024 07:00:00 PM,6,,,3,3
02/20/2024 08:00:00 PM,2,,,1,1
02/20/2024 09:00:00 PM,0,,,0,0
02/20/2024 10:00:00 PM,1,,,0,1
02/20/2024 11:00:00 PM,2,,,1,1
02/21/2024 12:00:00 AM,0,,,0,0
02/21/2024 01:00:00 AM,0,,,0,0
02/21/2024 02:00:00 AM,0,,,0,0
02/21/2024 03:00:00 AM,2,,,1,1
02/21/2024 04:00:00 AM,3,,,1,2
02/21/2024 05:00:00 AM,5,,,2,3
02/21/2024 06:00:00 AM,7,,,3,4
02/21/2024 07:00:00 AM,15,,,7,8
02/21/2024 08:00:00 AM,24,,,12,12
02/21/2024 09:00:00 AM,19,,,9,10
02/21/2024 10:00:00 AM,16,,,8,8
02/21/2024 11:00:00 AM,28,,,14,14
02/21/2024 12:00:00 PM,10,,,5,5
02/21/2024 01:00:00 PM,25,,,12,13
02/21/2024 02:00:00 PM,14,,,7,7
02/21/2024 03:00:00 PM,7,,,3,4
02/21/2024 04:00:00 PM,16,,,8,8
02/21/2024 05:00:00 PM,32,,,16,16
02/21/2024 06:00:00 PM,16,,,8,8
02/21/2024 07:00:00 PM,2,,,1,1
02/21/2024 08:00:00 PM,0,,,0,0
02/21/2024 09:00:00 PM,1,,,0,1
02/21/2024 10:00:00 PM,1,,,0,1
02/21/2024 11:00:00 PM,0,,,0,0
02/22/2024 12:00:00 AM,0,,,0,0
02/22/2024 01:00:00 AM,0,,,0,0
02/22/2024 02:00:00 AM,0,,,0,0
02/22/2024 03:00:00 AM,2,,,1,1
02/22/2024 04:00:00 AM,2,,,1,1
02/22/2024 05:00:00 AM,5,,,2,3
02/22/2024 06:00:00 AM,16,,,8,8
02/22/2024 07:00:00 AM,31,,,15,16
02/22/2024 08:00:00 AM,29,,,14,15
02/22/2024 09:00:00 AM,42,,,21,21
02/22/2024 10:00:00 AM,64,,,32,32
02/22/2024 11:00:00 AM,45,,,22,23
02/22/2024 12:00:00 PM,59,,,29,30
02/22/2024 01:00:00 PM,77,,,38,39
02/22/2024 02:00:00 PM,97,,,48,49
02/22/2024 03:00:00 PM,93,,,46,47
02/22/2024 04:00:00 PM,117,,,58,59
02/22/2024 05:00:00 PM,79,,,39,40
02/22/2024 06:00:00 PM,39,,,19,20
02/22/2024 07:00:00 PM,13,,,6,7
02/22/2024 08:00:00 PM,5,,,2,3
02/22/2024 09:00:00 PM,2,,,1,1
02/22/2024 10:00:00 PM,0,,,0,0
02/22/2024 11:00:00 PM,3,,,1,2
02/23/2024 12:00:00 AM,0,,,0,0
02/23/2024 01:00:00 AM,0,,,0,0
02/23/2024 02:00:00 AM,0,,,0,0
02/23/2024 03:00:00 AM,0,,,0,0
02/23/2024 04:00:00 AM,0,,,0,0
02/23/2024 05:00:00 AM,4,,,2,2
02/23/2024 06:00:00 AM,8,,,4,4
02/23/2024 07:00:00 AM,18,,,9,9
02/23/2024 08:00:00 AM,41,,,20,21
02/23/2024 09:00:00 AM,36,,,18,18
02/23/2024 10:00:00 AM,41,,,20,21
02/23/2024 11:00:00 AM,48,,,24,24
02/23/2024 12:00:00 PM,60,,,30,30
02/23/2024 01:00:00 PM,62,,,31,31
02/23/2024 02:00:00 PM,67,,,33,34
02/23/2024 03:00:00 PM,88,,,44,44
02/23/2024 04:00:00 PM,111,,,55,56
02/23/2024 05:00:00 PM,80,,,40,40
02/23/2024 06:00:00 PM,35,,,17,18
02/23/2024 07:00:00 PM,7,,,3,4
02/23/2024 08:00:00 PM,5,,,2,3
02/23/2024 09:00:00 PM,2,,,1,1
02/23/2024 10:00:00 PM,3,,,1,2
02/23/2024 11:00:00 PM,2,,,1,1
02/24/2024 12:00:00 AM,0,,,0,0
02/24/2024 01:00:00 AM,1,,,0,1
02/24/2024 02:00:00 AM,0,,,0,0
02/24/2024 03:00:00 AM,0,,,0,0
02/24/2024 04:00:00 AM,0,,,0,0
02/24/2024 05:00:00 AM,0,,,0,0
02/24/2024 06:00:00 AM,3,,,1,2
02/24/2024 07:00:00 AM,12,,,6,6
02/24/2024 08:00:00 AM,31,,,15,16
02/24/2024 09:00:00 AM,41,,,20,21
02/24/2024 10:00:00 AM,76,,,38,38
02/24/2024 11:00:00 AM,99,,,49,50
02/24/2024 12:00:00 PM,98,,,49,49
02/24/2024 01:00:00 PM,72,,,36,36
02/24/2024 02:00:00 PM,74,,,37,37
02/24/2024 03:00:00 PM,61,,,30,31
02/24/2024 04:00:00 PM,46,,,23,23
02/24/2024 05:00:00 PM,17,,,8,9
02/24/2024 06:00:00 PM,9,,,4,5
02/24/2024 07:00:00 PM,1,,,0,1
02/24/2024 08:00:00 PM,3,,,1,2
02/24/2024 09:00:00 PM,1,,,0,1
02/24/2024 10:00:00 PM,4,,,2,2
02/24/2024 11:00:00 PM,1,,,0,1
02/25/2024 12:00:00 AM,0,,,0,0
02/25/2024 01:00:00 AM,0,,,0,0
02/25/2024 02:00:00 AM,1,,,0,1
02/25/2024 03:00:00 AM,0,,,0,0
02/25/2024 04:00:00 AM,0,,,0,0
02/25/2024 05:00:00 AM,0,,,0,0
02/25/2024 06:00:00 AM,6,,,3,3
02/25/2024 07:00:00 AM,7,,,3,4
02/25/2024 08:00:00 AM,6,,,3,3
02/25/2024 09:00:00 AM,13,,,6,7
02/25/2024 10:00:00 AM,32,,,16,16
02/25/2024 11:00:00 AM,27,,,13,14
02/25/2024 12:00:00 PM,31,,,15,16
02/25/2024 01:00:00 PM,18,,,9,9
02/25/2024 02:00:00 PM,35,,,17,18
02/25/2024 03:00:00 PM,27,,,13,14
02/25/2024 04:00:00 PM,30,,,15,15
02/25/2024 05:00:00 PM,36,,,18,18
02/25/2024 06:00:00 PM,6,,,3,3
02/25/2024 07:00:00 PM,1,,,0,1
02/25/2024 08:00:00 PM,0,,,0,0
02/25/2024 09:00:00 PM,1,,,0,1
02/25/2024 10:00:00 PM,1,,,0,1
02/25/2024 11:00:00 PM,0,,,0,0
02/26/2024 12:00:00 AM,0,,,0,0
02/26/2024 01:00:00 AM,0,,,0,0
02/26/2024 02:00:00 AM,0,,,0,0
02/26/2024 03:00:00 AM,0,,,0,0
02/26/2024 04:00:00 AM,2,,,1,1
02/26/2024 05:00:00 AM,5,,,2,3
02/26/2024 06:00:00 AM,9,,,4,5
02/26/2024 07:00:00 AM,20,,,10,10
02/26/2024 08:00:00 AM,24,,,12,12
02/26/2024 09:00:00 AM,20,,,10,10
02/26/2024 10:00:00 AM,23,,,11,12
02/26/2024 11:00:00 AM,28,,,14,14
02/26/2024 12:00:00 PM,24,,,12,12
02/26/2024 01:00:00 PM,29,,,14,15
02/26/2024 02:00:00 PM,21,,,10,11
02/26/2024 03:00:00 PM,30,,,15,15
02/26/2024 04:00:00 PM,30,,,15,15
02/26/2024 05:00:00 PM,33,,,16,17
02/26/2024 06:00:00 PM,22,,,11,11
02/26/2024 07:00:00 PM,10,,,5,5
02/26/2024 08:00:00 PM,1,,,0,1
02/26/2024 09:00:00 PM,2,,,1,1
02/26/2024 10:00:00 PM,0,,,0,0
02/26/2024 11:00:00 PM,0,,,0,0
02/27/2024 12:00:00 AM,0,,,0,0
02/27/2024 01:00:00 AM,0,,,0,0
02/27/2024 02:00:00 AM,0,,,0,0
02/27/2024 03:00:00 AM,0,,,0,0
02/27/2024 04:00:00 AM,1,,,0,1
02/27/2024 05:00:00 AM,4,,,2,2
02/27/2024 06:00:00 AM,8,,,4,4
02/27/2024 07:00:00 AM,15,,,7,8
02/27/2024 08:00:00 AM,11,,,5,6
02/27/2024 09:00:00 AM,23,,,11,12
02/27/2024 10:00:00 AM,19,,,9,10
02/27/2024 11:00:00 AM,9,,,4,5
02/27/2024 12:00:00 PM,40,,,20,20
02/27/2024 01:00:00 PM,13,,,6,7
02/27/2024 02:00:00 PM,14,,,7,7
02/27/2024 03:00:00 PM,16,,,8,8
02/27/2024 04:00:00 PM,20,,,10,10
02/27/2024 05:00:00 PM,18,,,9,9
02/27/2024 06:00:00 PM,14,,,7,7
02/27/2024 07:00:00 PM,3,,,1,2
02/27/2024 08:00:00 PM,3,,,1,2
02/27/2024 09:00:00 PM,1,,,0,1
02/27/2024 10:00:00 PM,0,,,0,0
02/27/2024 11:00:00 PM,0,,,0,0
02/28/2024 12:00:00 AM,0,,,0,0
02/28/2024 01:00:00 AM,0,,,0,0
02/28/2024 02:00:00 AM,0,,,0,0
02/28/2024 03:00:00 AM,0,,,0,0
02/28/2024 04:00:00 AM,0,,,0,0
02/28/2024 05:00:00 AM,4,,,2,2
02/28/2024 06:00:00 AM,7,,,3,4
02/28/2024 07:00:00 AM,9,,,4,5
02/28/2024 08:00:00 AM,15,,,7,8
02/28/2024 09:00:00 AM,7,,,3,4
02/28/2024 10:00:00 AM,9,,,4,5
02/28/2024 11:00:00 AM,5,,,2,3
02/28/2024 12:00:00 PM,5,,,2,3
02/28/2024 01:00:00 PM,4,,,2,2
02/28/2024 02:00:00 PM,4,,,2,2
02/28/2024 03:00:00 PM,5,,,2,3
02/28/2024 04:00:00 PM,14,,,7,7
02/28/2024 05:00:00 PM,17,,,8,9
02/28/2024 06:00:00 PM,11,,,5,6
02/28/2024 07:00:00 PM,5,,,2,3
02/28/2024 08:00:00 PM,2,,,1,1
02/28/2024 09:00:00 PM,3,,,1,2
02/28/2024 10:00:00 PM,1,,,0,1
02/28/2024 11:00:00 PM,1,,,0,1
02/29/2024 12:00:00 AM,0,,,0,0
02/29/2024 01:00:00 AM,0,,,0,0
02/29/2024 02:00:00 AM,0,,,0,0
02/29/2024 03:00:00 AM,0,,,0,0
02/29/2024 04:00:00 AM,0,,,0,0
02/29/2024 05:00:00 AM,6,,,3,3
02/29/2024 06:00:00 AM,6,,,3,3
02/29/2024 07:00:00 AM,12,,,6,6
02/29/2024 08:00:00 AM,22,,,11,11
02/29/2024 09:00:00 AM,12,,,6,6
02/29/2024 10:00:00 AM,18,,,9,9
02/29/2024 11:00:00 AM,15,,,7,8
02/29/2024 12:00:00 PM,21,,,10,11
02/29/2024 01:00:00 PM,15,,,7,8
02/29/2024 02:00:00 PM,16,,,8,8
02/29/2024 03:00:00 PM,25,,,12,13
02/29/2024 04:00:00 PM,23,,,11,12
02/29/2024 05:00:00 PM,28,,,14,14
02/29/2024 06:00:00 PM,16,,,8,8
02/29/2024 07:00:00 PM,8,,,4,4
02/29/2024 08:00:00 PM,2,,,1,1
02/29/2024 09:00:00 PM,2,,,1,1
02/29/2024 10:00:00 PM,0,,,0,0
02/29/2024 11:00:00 PM,0,,,0,0
03/01/2024 12:00:00 AM,0,,,0,0
03/01/2024 01:00:00 AM,0,,,0,0
03/01/2024 02:00:00 AM,0,,,0,0
03/01/2024 03:00:00 AM,0,,,0,0
03/01/2024 04:00:00 AM,1,,,0,1
03/01/2024 05:00:00 AM,4,,,2,2
03/01/2024 06:00:00 AM,8,,,4,4
03/01/2024 07:00:00 AM,12,,,6,6
03/01/2024 08:00:00 AM,21,,,10,11
03/01/2024 09:00:00 AM,10,,,5,5
03/01/2024 10:00:00 AM,18,,,9,9
03/01/2024 11:00:00 AM,10,,,5,5
03/01/2024 12:00:00 PM,7,,,3,4
03/01/2024 01:00:00 PM,5,,,2,3
03/01/2024 02:00:00 PM,8,,,4,4
03/01/2024 03:00:00 PM,16,,,8,8
03/01/2024 04:00:00 PM,17,,,8,9
03/01/2024 05:00:00 PM,33,,,16,17
03/01/2024 06:00:00 PM,8,,,4,4
03/01/2024 07:00:00 PM,5,,,2,3
03/01/2024 08:00:00 PM,1,,,0,1
03/01/2024 09:00:00 PM,2,,,1,1
03/01/2024 10:00:00 PM,0,,,0,0
03/01/2024 11:00:00 PM,0,,,0,0
03/02/2024 12:00:00 AM,0,,,0,0
03/02/2024 01:00:00 AM,0,,,0,0
03/02/2024 02:00:00 AM,0,,,0,0
03/02/2024 03:00:00 AM,0,,,0,0
03/02/2024 04:00:00 AM,0,,,0,0
03/02/2024 05:00:00 AM,0,,,0,0
03/02/2024 06:00:00 AM,3,,,1,2
03/02/2024 07:00:00 AM,9,,,4,5
03/02/2024 08:00:00 AM,39,,,19,20
03/02/2024 09:00:00 AM,23,,,11,12
03/02/2024 10:00:00 AM,38,,,19,19
03/02/2024 11:00:00 AM,54,,,27,27
03/02/2024 12:00:00 PM,66,,,33,33
03/02/2024 01:00:00 PM,68,,,34,34
03/02/2024 02:00:00 PM,64,,,32,32
03/02/2024 03:00:00 PM,34,,,17,17
03/02/2024 04:00:00 PM,34,,,17,17
03/02/2024 05:00:00 PM,15,,,7,8
03/02/2024 06:00:00 PM,4,,,2,2
03/02/2024 07:00:00 PM,2,,,1,1
03/02/2024 08:00:00 PM,0,,,0,0
03/02/2024 09:00:00 PM,0,,,0,0
03/02/2024 10:00:00 PM,1,,,0,1
03/02/2024 11:00:00 PM,1,,,0,1
03/03/2024 12:00:00 AM,0,,,0,0
03/03/2024 01:00:00 AM,0,,,0,0
03/03/2024 02:00:00 AM,0,,,0,0
03/03/2024 03:00:00 AM,0,,,0,0
03/03/2024 04:00:00 AM,0,,,0,0
03/03/2024 05:00:00 AM,0,,,0,0
03/03/2024 06:00:00 AM,2,,,1,1
03/03/2024 07:00:00 AM,5,,,2,3
03/03/2024 08:00:00 AM,3,,,1,2
03/03/2024 09:00:00 AM,10,,,5,5
03/03/2024 10:00:00 AM,10,,,5,5
03/03/2024 11:00:00 AM,14,,,7,7
03/03/2024 12:00:00 PM,22,,,11,11
03/03/2024 01:00:00 PM,37,,,18,19
03/03/2024 02:00:00 PM,31,,,15,16
03/03/2024 03:00:00 PM,44,,,22,22
03/03/2024 04:00:00 PM,34,,,17,17
03/03/2024 05:00:00 PM,23,,,11,12
03/03/2024 06:00:00 PM,5,,,2,3
03/03/2024 07:00:00 PM,2,,,1,1
03/03/2024 08:00:00 PM,1,,,0,1
03/03/2024 09:00:00 PM,3,,,1,2
03/03/2024 10:00:00 PM,0,,,0,0
03/03/2024 11:00:00 PM,1,,,0,1
03/04/2024 12:00:00 AM,1,,,0,1
03/04/2024 01:00:00 AM,0,,,0,0
03/04/2024 02:00:00 AM,0,,,0,0
03/04/2024 03:00:00 AM,0,,,0,0
03/04/2024 04:00:00 AM,1,,,0,1
03/04/2024 05:00:00 AM,5,,,2,3
03/04/2024 06:00:00 AM,10,,,5,5
03/04/2024 07:00:00 AM,22,,,11,11
03/04/2024 08:00:00 AM,29,,,14,15
03/04/2024 09:00:00 AM,22,,,11,11
03/04/2024 10:00:00 AM,35,,,17,18
03/04/2024 11:00:00 AM,26,,,13,13
03/04/2024 12:00:00 PM,26,,,13,13
03/04/2024 01:00:00 PM,31,,,15,16
03/04/2024 02:00:00 PM,23,,,11,12
03/04/2024 03:00:00 PM,31,,,15,16
03/04/2024 04:00:00 PM,44,,,22,22
03/04/2024 05:00:00 PM,46,,,23,23
03/04/2024 06:00:00 PM,21,,,10,11
03/04/2024 07:00:00 PM,7,,,3,4
03/04/2024 08:00:00 PM,7,,,3,4
03/04/2024 09:00:00 PM,4,,,2,2
03/04/2024 10:00:00 PM,1,,,0,1
03/04/2024 11:00:00 PM,0,,,0,0
03/05/2024 12:00:00 AM,0,,,0,0
03/05/2024 01:00:00 AM,0,,,0,0
03/05/2024 02:00:00 AM,0,,,0,0
03/05/2024 03:00:00 AM,0,,,0,0
03/05/2024 04:00:00 AM,1,,,0,1
03/05/2024 05:00:00 AM,8,,,4,4
03/05/2024 06:00:00 AM,8,,,4,4
03/05/2024 07:00:00 AM,19,,,9,10
03/05/2024 08:00:00 AM,38,,,19,19
03/05/2024 09:00:00 AM,18,,,9,9
03/05/2024 10:00:00 AM,25,,,12,13
03/05/2024 11:00:00 AM,19,,,9,10
03/05/2024 12:00:00 PM,28,,,14,14
03/05/2024 01:00:00 PM,36,,,18,18
03/05/2024 02:00:00 PM,46,,,23,23
03/05/2024 03:00:00 PM,49,,,24,25
03/05/2024 04:00:00 PM,82,,,41,41
03/05/2024 05:00:00 PM,67,,,33,34
03/05/2024 06:00:00 PM,32,,,16,16
03/05/2024 07:00:00 PM,9,,,4,5
03/05/2024 08:00:00 PM,5,,,2,3
03/05/2024 09:00:00 PM,2,,,1,1
03/05/2024 10:00:00 PM,1,,,0,1
03/05/2024 11:00:00 PM,1,,,0,1
03/06/2024 12:00:00 AM,0,,,0,0
03/06/2024 01:00:00 AM,0,,,0,0
03/06/2024 02:00:00 AM,0,,,0,0
03/06/2024 03:00:00 AM,0,,,0,0
03/06/2024 04:00:00 AM,2,,,1,1
03/06/2024 05:00:00 AM,2,,,1,1
03/06/2024 06:00:00 AM,14,,,7,7
03/06/2024 07:00:00 AM,19,,,9,10
03/06/2024 08:00:00 AM,23,,,11,12
03/06/2024 09:00:00 AM,26,,,13,13
03/06/2024 10:00:00 AM,25,,,12,13
03/06/2024 11:00:00 AM,32,,,16,16
03/06/2024 12:00:00 PM,23,,,11,12
03/06/2024 01:00:00 PM,30,,,15,15
03/06/2024 02:00:00 PM,28,,,14,14
03/06/2024 03:00:00 PM,46,,,23,23
03/06/2024 04:00:00 PM,47,,,23,24
03/06/2024 05:00:00 PM,57,,,28,29
03/06/2024 06:00:00 PM,27,,,13,14
03/06/2024 07:00:00 PM,8,,,4,4
03/06/2024 08:00:00 PM,2,,,1,1
03/06/2024 09:00:00 PM,4,,,2,2
03/06/2024 10:00:00 PM,2,,,1,1
03/06/2024 11:00:00 PM,0,,,0,0
03/07/2024 12:00:00 AM,1,,,0,1
03/07/2024 01:00:00 AM,0,,,0,0
03/07/2024 02:00:00 AM,0,,,0,0
03/07/2024 03:00:00 AM,0,,,0,0
03/07/2024 04:00:00 AM,0,,,0,0
03/07/2024 05:00:00 AM,7,,,3,4
03/07/2024 06:00:00 AM,10,,,5,5
03/07/2024 07:00:00 AM,21,,,10,11
03/07/2024 08:00:00 AM,37,,,18,19
03/07/2024 09:00:00 AM,25,,,12,13
03/07/2024 10:00:00 AM,18,,,9,9
03/07/2024 11:00:00 AM,35,,,17,18
03/07/2024 12:00:00 PM,37,,,18,19
03/07/2024 01:00:00 PM,36,,,18,18
03/07/2024 02:00:00 PM,35,,,17,18
03/07/2024 03:00:00 PM,60,,,30,30
03/07/2024 04:00:00 PM,70,,,35,35
03/07/2024 05:00:00 PM,63,,,31,32
03/07/2024 06:00:00 PM,31,,,15,16
03/07/2024 07:00:00 PM,12,,,6,6
03/07/2024 08:00:00 PM,6,,,3,3
03/07/2024 09:00:00 PM,1,,,0,1
03/07/2024 10:00:00 PM,0,,,0,0
03/07/2024 11:00:00 PM,1,,,0,1
03/08/2024 12:00:00 AM,1,,,0,1
03/08/2024 01:00:00 AM,1,,,0,1
03/08/2024 02:00:00 AM,1,,,0,1
03/08/2024 03:00:00 AM,0,,,0,0
03/08/2024 04:00:00 AM,0,,,0,0
03/08/2024 05:00:00 AM,5,,,2,3
03/08/2024 06:00:00 AM,11,,,5,6
03/08/2024 07:00:00 AM,23,,,11,12
03/08/2024 08:00:00 AM,29,,,14,15
03/08/2024 09:00:00 AM,25,,,12,13
03/08/2024 10:00:00 AM,19,,,9,10
03/08/2024 11:00:00 AM,25,,,12,13
03/08/2024 12:00:00 PM,34,,,17,17
03/08/2024 01:00:00 PM,31,,,15,16
03/08/2024 02:00:00 PM,50,,,25,25
03/08/2024 03:00:00 PM,41,,,20,21
03/08/2024 04:00:00 PM,59,,,29,30
03/08/2024 05:00:00 PM,61,,,30,31
03/08/2024 06:00:00 PM,22,,,11,11
03/08/2024 07:00:00 PM,9,,,4,5
03/08/2024 08:00:00 PM,2,,,1,1
03/08/2024 09:00:00 PM,2,,,1,1
03/08/2024 10:00:00 PM,0,,,0,0
03/08/2024 11:00:00 PM,1,,,0,1
03/09/2024 12:00:00 AM,0,,,0,0
03/09/2024 01:00:00 AM,0,,,0,0
03/09/2024 02:00:00 AM,0,,,0,0
03/09/2024 03:00:00 AM,0,,,0,0
03/09/2024 04:00:00 AM,0,,,0,0
03/09/2024 05:00:00 AM,0,,,0,0
03/09/2024 06:00:00 AM,1,,,0,1
03/09/2024 07:00:00 AM,18,,,9,9
03/09/2024 08:00:00 AM,29,,,14,15
03/09/2024 09:00:00 AM,29,,,14,15
03/09/2024 10:00:00 AM,22,,,11,11
03/09/2024 11:00:00 AM,47,,,23,24
03/09/2024 12:00:00 PM,30,,,15,15
03/09/2024 01:00:00 PM,23,,,11,12
03/09/2024 02:00:00 PM,42,,,21,21
03/09/2024 03:00:00 PM,15,,,7,8
03/09/2024 04:00:00 PM,40,,,20,20
03/09/2024 05:00:00 PM,16,,,8,8
03/09/2024 06:00:00 PM,4,,,2,2
03/09/2024 07:00:00 PM,7,,,3,4
03/09/2024 08:00:00 PM,0,,,0,0
03/09/2024 09:00:00 PM,0,,,0,0
03/09/2024 10:00:00 PM,0,,,0,0
03/09/2024 11:00:00 PM,0,,,0,0
03/10/2024 12:00:00 AM,0,,,0,0
03/10/2024 01:00:00 AM,0,,,0,0
03/10/2024 02:00:00 AM,,,,,
03/10/2024 03:00:00 AM,1,,,0,1
03/10/2024 04:00:00 AM,0,,,0,0
03/10/2024 05:00:00 AM,1,,,0,1
03/10/2024 06:00:00 AM,2,,,1,1
03/10/2024 07:00:00 AM,4,,,2,2
03/10/2024 08:00:00 AM,9,,,4,5
03/10/2024 09:00:00 AM,14,,,7,7
03/10/2024 10:00:00 AM,23,,,11,12
03/10/2024 11:00:00 AM,29,,,14,15
03/10/2024 12:00:00 PM,17,,,8,9
03/10/2024 01:00:00 PM,21,,,10,11
03/10/2024 02:00:00 PM,11,,,5,6
03/10/2024 03:00:00 PM,12,,,6,6
03/10/2024 04:00:00 PM,12,,,6,6
03/10/2024 05:00:00 PM,5,,,2,3
03/10/2024 06:00:00 PM,2,,,1,1
03/10/2024 07:00:00 PM,1,,,0,1
03/10/2024 08:00:00 PM,3,,,1,2
03/10/2024 09:00:00 PM,0,,,0,0
03/10/2024 10:00:00 PM,0,,,0,0
03/10/2024 11:00:00 PM,1,,,0,1
03/11/2024 12:00:00 AM,0,,,0,0
03/11/2024 01:00:00 AM,0,,,0,0
03/11/2024 02:00:00 AM,0,,,0,0
03/11/2024 03:00:00 AM,0,,,0,0
03/11/2024 04:00:00 AM,0,,,0,0
03/11/2024 05:00:00 AM,7,,,3,4
03/11/2024 06:00:00 AM,10,,,5,5
03/11/2024 07:00:00 AM,13,,,6,7
03/11/2024 08:00:00 AM,29,,,14,15
03/11/2024 09:00:00 AM,17,,,8,9
03/11/2024 10:00:00 AM,27,,,13,14
03/11/2024 11:00:00 AM,15,,,7,8
03/11/2024 12:00:00 PM,23,,,11,12
03/11/2024 01:00:00 PM,16,,,8,8
03/11/2024 02:00:00 PM,15,,,7,8
03/11/2024 03:00:00 PM,13,,,6,7
03/11/2024 04:00:00 PM,16,,,8,8
03/11/2024 05:00:00 PM,28,,,14,14
03/11/2024 06:00:00 PM,18,,,9,9
03/11/2024 07:00:00 PM,6,,,3,3
03/11/2024 08:00:00 PM,0,,,0,0
03/11/2024 09:00:00 PM,0,,,0,0
03/11/2024 10:00:00 PM,0,,,0,0
03/11/2024 11:00:00 PM,1,,,0,1
03/12/2024 12:00:00 AM,0,,,0,0
03/12/2024 01:00:00 AM,0,,,0,0
03/12/2024 02:00:00 AM,0,,,0,0
03/12/2024 03:00:00 AM,0,,,0,0
03/12/2024 04:00:00 AM,2,,,1,1
03/12/2024 05:00:00 AM,4,,,2,2
03/12/2024 06:00:00 AM,6,,,3,3
03/12/2024 07:00:00 AM,16,,,8,8
03/12/2024 08:00:00 AM,29,,,14,15
03/12/2024 09:00:00 AM,14,,,7,7
03/12/2024 10:00:00 AM,10,,,5,5
03/12/2024 11:00:00 AM,14,,,7,7
03/12/2024 12:00:00 PM,17,,,8,9
03/12/2024 01:00:00 PM,15,,,7,8
03/12/2024 02:00:00 PM,31,,,15,16
03/12/2024 03:00:00 PM,20,,,10,10
03/12/2024 04:00:00 PM,33,,,16,17
03/12/2024 05:00:00 PM,57,,,28,29
03/12/2024 06:00:00 PM,25,,,12,13
03/12/2024 07:00:00 PM,7,,,3,4
03/12/2024 08:00:00 PM,3,,,1,2
03/12/2024 09:00:00 PM,5,,,2,3
03/12/2024 10:00:00 PM,1,,,0,1
03/12/2024 11:00:00 PM,1,,,0,1
03/13/2024 12:00:00 AM,0,,,0,0
03/13/2024 01:00:00 AM,0,,,0,0
03/13/2024 02:00:00 AM,0,,,0,0
03/13/2024 03:00:00 AM,0,,,0,0
03/13/2024 04:00:00 AM,0,,,0,0
03/13/2024 05:00:00 AM,4,,,2,2
03/13/2024 06:00:00 AM,11,,,5,6
03/13/2024 07:00:00 AM,25,,,12,13
03/13/2024 08:00:00 AM,41,,,20,21
03/13/2024 09:00:00 AM,35,,,17,18
03/13/2024 10:00:00 AM,22,,,11,11
03/13/2024 11:00:00 AM,41,,,20,21
03/13/2024 12:00:00 PM,30,,,15,15
03/13/2024 01:00:00 PM,29,,,14,15
03/13/2024 02:00:00 PM,53,,,26,27
03/13/2024 03:00:00 PM,46,,,23,23
03/13/2024 04:00:00 PM,70,,,35,35
03/13/2024 05:00:00 PM,75,,,37,38
03/13/2024 06:00:00 PM,56,,,28,28
03/13/2024 07:00:00 PM,24,,,12,12
03/13/2024 08:00:00 PM,5,,,2,3
03/13/2024 09:00:00 PM,9,,,4,5
03/13/2024 10:00:00 PM,0,,,0,0
03/13/2024 11:00:00 PM,0,,,0,0
03/14/2024 12:00:00 AM,0,,,0,0
03/14/2024 01:00:00 AM,0,,,0,0
03/14/2024 02:00:00 AM,0,,,0,0
03/14/2024 03:00:00 AM,0,,,0,0
03/14/2024 04:00:00 AM,2,,,1,1
03/14/2024 05:00:00 AM,7,,,3,4
03/14/2024 06:00:00 AM,17,,,8,9
03/14/2024 07:00:00 AM,22,,,11,11
03/14/2024 08:00:00 AM,35,,,17,18
03/14/2024 09:00:00 AM,23,,,11,12
03/14/2024 10:00:00 AM,40,,,20,20
03/14/2024 11:00:00 AM,29,,,14,15
03/14/2024 12:00:00 PM,44,,,22,22
03/14/2024 01:00:00 PM,50,,,25,25
03/14/2024 02:00:00 PM,84,,,42,42
03/14/2024 03:00:00 PM,79,,,39,40
03/14/2024 04:00:00 PM,118,,,59,59
03/14/2024 05:00:00 PM,109,,,54,55
03/14/2024 06:00:00 PM,75,,,37,38
03/14/2024 07:00:00 PM,34,,,17,17
03/14/2024 08:00:00 PM,7,,,3,4
03/14/2024 09:00:00 PM,5,,,2,3
03/14/2024 10:00:00 PM,1,,,0,1
03/14/2024 11:00:00 PM,1,,,0,1
03/15/2024 12:00:00 AM,0,,,0,0
03/15/2024 01:00:00 AM,0,,,0,0
03/15/2024 02:00:00 AM,0,,,0,0
03/15/2024 03:00:00 AM,0,,,0,0
03/15/2024 04:00:00 AM,0,,,0,0
03/15/2024 05:00:00 AM,6,,,3,3
03/15/2024 06:00:00 AM,12,,,6,6
03/15/2024 07:00:00 AM,21,,,10,11
03/15/2024 08:00:00 AM,35,,,17,18
03/15/2024 09:00:00 AM,49,,,24,25
03/15/2024 10:00:00 AM,54,,,27,27
03/15/2024 11:00:00 AM,66,,,33,33
03/15/2024 12:00:00 PM,68,,,34,34
03/15/2024 01:00:00 PM,81,,,40,41
03/15/2024 02:00:00 PM,104,,,52,52
03/15/2024 03:00:00 PM,102,,,51,51
03/15/2024 04:00:00 PM,121,,,60,61
03/15/2024 05:00:00 PM,120,,,60,60
03/15/2024 06:00:00 PM,69,,,34,35
03/15/2024 07:00:00 PM,36,,,18,18
03/15/2024 08:00:00 PM,6,,,3,3
03/15/2024 09:00:00 PM,4,,,2,2
03/15/2024 10:00:00 PM,4,,,2,2
03/15/2024 11:00:00 PM,0,,,0,0
03/16/2024 12:00:00 AM,0,,,0,0
03/16/2024 01:00:00 AM,0,,,0,0
03/16/2024 02:00:00 AM,0,,,0,0
03/16/2024 03:00:00 AM,0,,,0,0
03/16/2024 04:00:00 AM,0,,,0,0
03/16/2024 05:00:00 AM,3,,,1,2
03/16/2024 06:00:00 AM,10,,,5,5
03/16/2024 07:00:00 AM,24,,,12,12
03/16/2024 08:00:00 AM,64,,,32,32
03/16/2024 09:00:00 AM,94,,,47,47
03/16/2024 10:00:00 AM,175,,,87,88
03/16/2024 11:00:00 AM,262,,,131,131
03/16/2024 12:00:00 PM,290,,,145,145
03/16/2024 01:00:00 PM,244,,,122,122
03/16/2024 02:00:00 PM,288,,,144,144
03/16/2024 03:00:00 PM,255,,,127,128
03/16/2024 04:00:00 PM,209,,,104,105
03/16/2024 05:00:00 PM,169,,,84,85
03/16/2024 06:00:00 PM,85,,,42,43
03/16/2024 07:00:00 PM,51,,,25,26
03/16/2024 08:00:00 PM,9,,,4,5
03/16/2024 09:00:00 PM,7,,,3,4
03/16/2024 10:00:00 PM,3,,,1,2
03/16/2024 11:00:00 PM,3,,,1,2
03/17/2024 12:00:00 AM,2,,,1,1
03/17/2024 01:00:00 AM,1,,,0,1
03/17/2024 02:00:00 AM,0,,,0,0
03/17/2024 03:00:00 AM,0,,,0,0
03/17/2024 04:00:00 AM,0,,,0,0
03/17/2024 05:00:00 AM,0,,,0,0
03/17/2024 06:00:00 AM,2,,,1,1
03/17/2024 07:00:00 AM,24,,,12,12
03/17/2024 08:00:00 AM,54,,,27,27
03/17/2024 09:00:00 AM,90,,,45,45
03/17/2024 10:00:00 AM,142,,,71,71
03/17/2024 11:00:00 AM,209,,,104,105
03/17/2024 12:00:00 PM,251,,,125,126
03/17/2024 01:00:00 PM,297,,,148,149
03/17/2024 02:00:00 PM,307,,,153,154
03/17/2024 03:00:00 PM,240,,,120,120
03/17/2024 04:00:00 PM,232,,,116,116
03/17/2024 05:00:00 PM,151,,,75,76
03/17/2024 06:00:00 PM,83,,,41,42
03/17/2024 07:00:00 PM,37,,,18,19
03/17/2024 08:00:00 PM,12,,,6,6
03/17/2024 09:00:00 PM,5,,,2,3
03/17/2024 10:00:00 PM,1,,,0,1
03/17/2024 11:00:00 PM,0,,,0,0
03/18/2024 12:00:00 AM,3,,,1,2
03/18/2024 01:00:00 AM,0,,,0,0
03/18/2024 02:00:00 AM,0,,,0,0
03/18/2024 03:00:00 AM,1,,,0,1
03/18/2024 04:00:00 AM,3,,,1,2
03/18/2024 05:00:00 AM,7,,,3,4
03/18/2024 06:00:00 AM,15,,,7,8
03/18/2024 07:00:00 AM,27,,,13,14
03/18/2024 08:00:00 AM,48,,,24,24
03/18/2024 09:00:00 AM,38,,,19,19
03/18/2024 10:00:00 AM,78,,,39,39
03/18/2024 11:00:00 AM,47,,,23,24
03/18/2024 12:00:00 PM,70,,,35,35
03/18/2024 01:00:00 PM,68,,,34,34
03/18/2024 02:00:00 PM,79,,,39,40
03/18/2024 03:00:00 PM,100,,,50,50
03/18/2024 04:00:00 PM,136,,,68,68
03/18/2024 05:00:00 PM,169,,,84,85
03/18/2024 06:00:00 PM,100,,,50,50
03/18/2024 07:00:00 PM,34,,,17,17
03/18/2024 08:00:00 PM,9,,,4,5
03/18/2024 09:00:00 PM,2,,,1,1
03/18/2024 10:00:00 PM,2,,,1,1
03/18/2024 11:00:00 PM,0,,,0,0
03/19/2024 12:00:00 AM,0,,,0,0
03/19/2024 01:00:00 AM,0,,,0,0
03/19/2024 02:00:00 AM,0,,,0,0
03/19/2024 03:00:00 AM,0,,,0,0
03/19/2024 04:00:00 AM,1,,,0,1
03/19/2024 05:00:00 AM,7,,,3,4
03/19/2024 06:00:00 AM,17,,,8,9
03/19/2024 07:00:00 AM,42,,,21,21
03/19/2024 08:00:00 AM,44,,,22,22
03/19/2024 09:00:00 AM,53,,,26,27
03/19/2024 10:00:00 AM,42,,,21,21
03/19/2024 11:00:00 AM,67,,,33,34
03/19/2024 12:00:00 PM,70,,,35,35
03/19/2024 01:00:00 PM,111,,,55,56
03/19/2024 02:00:00 PM,110,,,55,55
03/19/2024 03:00:00 PM,112,,,56,56
03/19/2024 04:00:00 PM,162,,,81,81
03/19/2024 05:00:00 PM,157,,,78,79
03/19/2024 06:00:00 PM,146,,,73,73
03/19/2024 07:00:00 PM,40,,,20,20
03/19/2024 08:00:00 PM,10,,,5,5
03/19/2024 09:00:00 PM,10,,,5,5
03/19/2024 10:00:00 PM,0,,,0,0
03/19/2024 11:00:00 PM,2,,,1,1
03/20/2024 12:00:00 AM,1,,,0,1
03/20/2024 01:00:00 AM,0,,,0,0
03/20/2024 02:00:00 AM,2,,,1,1
03/20/2024 03:00:00 AM,2,,,1,1
03/20/2024 04:00:00 AM,0,,,0,0
03/20/2024 05:00:00 AM,4,,,2,2
03/20/2024 06:00:00 AM,18,,,9,9
03/20/2024 07:00:00 AM,21,,,10,11
03/20/2024 08:00:00 AM,29,,,14,15
03/20/2024 09:00:00 AM,26,,,13,13
03/20/2024 10:00:00 AM,35,,,17,18
03/20/2024 11:00:00 AM,42,,,21,21
03/20/2024 12:00:00 PM,20,,,10,10
03/20/2024 01:00:00 PM,44,,,22,22
03/20/2024 02:00:00 PM,31,,,15,16
03/20/2024 03:00:00 PM,46,,,23,23
03/20/2024 04:00:00 PM,52,,,26,26
03/20/2024 05:00:00 PM,59,,,29,30
03/20/2024 06:00:00 PM,47,,,23,24
03/20/2024 07:00:00 PM,13,,,6,7
03/20/2024 08:00:00 PM,4,,,2,2
03/20/2024 09:00:00 PM,2,,,1,1
03/20/2024 10:00:00 PM,1,,,0,1
03/20/2024 11:00:00 PM,1,,,0,1
03/21/2024 12:00:00 AM,0,,,0,0
03/21/2024 01:00:00 AM,2,,,1,1
03/21/2024 02:00:00 AM,0,,,0,0
03/21/2024 03:00:00 AM,0,,,0,0
03/21/2024 04:00:00 AM,1,,,0,1
03/21/2024 05:00:00 AM,4,,,2,2
03/21/2024 06:00:00 AM,9,,,4,5
03/21/2024 07:00:00 AM,26,,,13,13
03/21/2024 08:00:00 AM,32,,,16,16
03/21/2024 09:00:00 AM,23,,,11,12
03/21/2024 10:00:00 AM,27,,,13,14
03/21/2024 11:00:00 AM,37,,,18,19
03/21/2024 12:00:00 PM,27,,,13,14
03/21/2024 01:00:00 PM,50,,,25,25
03/21/2024 02:00:00 PM,55,,,27,28
03/21/2024 03:00:00 PM,54,,,27,27
03/21/2024 04:00:00 PM,58,,,29,29
03/21/2024 05:00:00 PM,81,,,40,41
03/21/2024 06:00:00 PM,53,,,26,27
03/21/2024 07:00:00 PM,11,,,5,6
03/21/2024 08:00:00 PM,6,,,3,3
03/21/2024 09:00:00 PM,8,,,4,4
03/21/2024 10:00:00 PM,0,,,0,0
03/21/2024 11:00:00 PM,0,,,0,0
03/22/2024 12:00:00 AM,0,,,0,0
03/22/2024 01:00:00 AM,0,,,0,0
03/22/2024 02:00:00 AM,0,,,0,0
03/22/2024 03:00:00 AM,0,,,0,0
03/22/2024 04:00:00 AM,1,,,0,1
03/22/2024 05:00:00 AM,5,,,2,3
03/22/2024 06:00:00 AM,17,,,8,9
03/22/2024 07:00:00 AM,20,,,10,10
03/22/2024 08:00:00 AM,24,,,12,12
03/22/2024 09:00:00 AM,27,,,13,14
03/22/2024 10:00:00 AM,34,,,17,17
03/22/2024 11:00:00 AM,20,,,10,10
03/22/2024 12:00:00 PM,12,,,6,6
03/22/2024 01:00:00 PM,19,,,9,10
03/22/2024 02:00:00 PM,12,,,6,6
03/22/2024 03:00:00 PM,23,,,11,12
03/22/2024 04:00:00 PM,30,,,15,15
03/22/2024 05:00:00 PM,44,,,22,22
03/22/2024 06:00:00 PM,21,,,10,11
03/22/2024 07:00:00 PM,8,,,4,4
03/22/2024 08:00:00 PM,2,,,1,1
03/22/2024 09:00:00 PM,0,,,0,0
03/22/2024 10:00:00 PM,0,,,0,0
03/22/2024 11:00:00 PM,3,,,1,2
03/23/2024 12:00:00 AM,1,,,0,1
03/23/2024 01:00:00 AM,1,,,0,1
03/23/2024 02:00:00 AM,0,,,0,0
03/23/2024 03:00:00 AM,0,,,0,0
03/23/2024 04:00:00 AM,0,,,0,0
03/23/2024 05:00:00 AM,0,,,0,0
03/23/2024 06:00:00 AM,1,,,0,1
03/23/2024 07:00:00 AM,8,,,4,4
03/23/2024 08:00:00 AM,18,,,9,9
03/23/2024 09:00:00 AM,15,,,7,8
03/23/2024 10:00:00 AM,13,,,6,7
03/23/2024 11:00:00 AM,12,,,6,6
03/23/2024 12:00:00 PM,23,,,11,12
03/23/2024 01:00:00 PM,25,,,12,13
03/23/2024 02:00:00 PM,42,,,21,21
03/23/2024 03:00:00 PM,36,,,18,18
03/23/2024 04:00:00 PM,36,,,18,18
03/23/2024 05:00:00 PM,24,,,12,12
03/23/2024 06:00:00 PM,16,,,8,8
03/23/2024 07:00:00 PM,7,,,3,4
03/23/2024 08:00:00 PM,9,,,4,5
03/23/2024 09:00:00 PM,3,,,1,2
03/23/2024 10:00:00 PM,0,,,0,0
03/23/2024 11:00:00 PM,0,,,0,0
03/24/2024 12:00:00 AM,0,,,0,0
03/24/2024 01:00:00 AM,1,,,0,1
03/24/2024 02:00:00 AM,0,,,0,0
03/24/2024 03:00:00 AM,0,,,0,0
03/24/2024 04:00:00 AM,0,,,0,0
03/24/2024 05:00:00 AM,0,,,0,0
03/24/2024 06:00:00 AM,3,,,1,2
03/24/2024 07:00:00 AM,15,,,7,8
03/24/2024 08:00:00 AM,27,,,13,14
03/24/2024 09:00:00 AM,18,,,9,9
03/24/2024 10:00:00 AM,130,,,65,65
03/24/2024 11:00:00 AM,129,,,64,65
03/24/2024 12:00:00 PM,147,,,73,74
03/24/2024 01:00:00 PM,212,,,106,106
03/24/2024 02:00:00 PM,216,,,108,108
03/24/2024 03:00:00 PM,211,,,105,106
03/24/2024 04:00:00 PM,174,,,87,87
03/24/2024 05:00:00 PM,147,,,73,74
03/24/2024 06:00:00 PM,65,,,32,33
03/24/2024 07:00:00 PM,26,,,13,13
03/24/2024 08:00:00 PM,10,,,5,5
03/24/2024 09:00:00 PM,2,,,1,1
03/24/2024 10:00:00 PM,3,,,1,2
03/24/2024 11:00:00 PM,1,,,0,1
03/25/2024 12:00:00 AM,0,,,0,0
03/25/2024 01:00:00 AM,1,,,0,1
03/25/2024 02:00:00 AM,0,,,0,0
03/25/2024 03:00:00 AM,0,,,0,0
03/25/2024 04:00:00 AM,2,,,1,1
03/25/2024 05:00:00 AM,2,,,1,1
03/25/2024 06:00:00 AM,17,,,8,9
03/25/2024 07:00:00 AM,26,,,13,13
03/25/2024 08:00:00 AM,27,,,13,14
03/25/2024 09:00:00 AM,36,,,18,18
03/25/2024 10:00:00 AM,18,,,9,9
03/25/2024 11:00:00 AM,24,,,12,12
03/25/2024 12:00:00 PM,19,,,9,10
03/25/2024 01:00:00 PM,33,,,16,17
03/25/2024 02:00:00 PM,25,,,12,13
03/25/2024 03:00:00 PM,21,,,10,11
03/25/2024 04:00:00 PM,41,,,20,21
03/25/2024 05:00:00 PM,53,,,26,27
03/25/2024 06:00:00 PM,27,,,13,14
03/25/2024 07:00:00 PM,19,,,9,10
03/25/2024 08:00:00 PM,8,,,4,4
03/25/2024 09:00:00 PM,3,,,1,2
03/25/2024 10:00:00 PM,1,,,0,1
03/25/2024 11:00:00 PM,1,,,0,1
03/26/2024 12:00:00 AM,0,,,0,0
03/26/2024 01:00:00 AM,0,,,0,0
03/26/2024 02:00:00 AM,0,,,0,0
03/26/2024 03:00:00 AM,0,,,0,0
03/26/2024 04:00:00 AM,3,,,1,2
03/26/2024 05:00:00 AM,4,,,2,2
03/26/2024 06:00:00 AM,18,,,9,9
03/26/2024 07:00:00 AM,24,,,12,12
03/26/2024 08:00:00 AM,56,,,28,28
03/26/2024 09:00:00 AM,31,,,15,16
03/26/2024 10:00:00 AM,12,,,6,6
03/26/2024 11:00:00 AM,22,,,11,11
03/26/2024 12:00:00 PM,31,,,15,16
03/26/2024 01:00:00 PM,38,,,19,19
03/26/2024 02:00:00 PM,41,,,20,21
03/26/2024 03:00:00 PM,59,,,29,30
03/26/2024 04:00:00 PM,58,,,29,29
03/26/2024 05:00:00 PM,99,,,49,50
03/26/2024 06:00:00 PM,66,,,33,33
03/26/2024 07:00:00 PM,31,,,15,16
03/26/2024 08:00:00 PM,7,,,3,4
03/26/2024 09:00:00 PM,3,,,1,2
03/26/2024 10:00:00 PM,3,,,1,2
03/26/2024 11:00:00 PM,3,,,1,2
03/27/2024 12:00:00 AM,1,,,0,1
03/27/2024 01:00:00 AM,0,,,0,0
03/27/2024 02:00:00 AM,0,,,0,0
03/27/2024 03:00:00 AM,0,,,0,0
03/27/2024 04:00:00 AM,1,,,0,1
03/27/2024 05:00:00 AM,3,,,1,2
03/27/2024 06:00:00 AM,10,,,5,5
03/27/2024 07:00:00 AM,9,,,4,5
03/27/2024 08:00:00 AM,21,,,10,11
03/27/2024 09:00:00 AM,13,,,6,7
03/27/2024 10:00:00 AM,9,,,4,5
03/27/2024 11:00:00 AM,8,,,4,4
03/27/2024 12:00:00 PM,16,,,8,8
03/27/2024 01:00:00 PM,8,,,4,4
03/27/2024 02:00:00 PM,16,,,8,8
03/27/2024 03:00:00 PM,11,,,5,6
03/27/2024 04:00:00 PM,24,,,12,12
03/27/2024 05:00:00 PM,57,,,28,29
03/27/2024 06:00:00 PM,30,,,15,15
03/27/2024 07:00:00 PM,15,,,7,8
03/27/2024 08:00:00 PM,7,,,3,4
03/27/2024 09:00:00 PM,4,,,2,2
03/27/2024 10:00:00 PM,1,,,0,1
03/27/2024 11:00:00 PM,1,,,0,1
03/28/2024 12:00:00 AM,0,,,0,0
03/28/2024 01:00:00 AM,0,,,0,0
03/28/2024 02:00:00 AM,0,,,0,0
03/28/2024 03:00:00 AM,0,,,0,0
03/28/2024 04:00:00 AM,1,,,0,1
03/28/2024 05:00:00 AM,3,,,1,2
03/28/2024 06:00:00 AM,8,,,4,4
03/28/2024 07:00:00 AM,20,,,10,10
03/28/2024 08:00:00 AM,36,,,18,18
03/28/2024 09:00:00 AM,19,,,9,10
03/28/2024 10:00:00 AM,24,,,12,12
03/28/2024 11:00:00 AM,23,,,11,12
03/28/2024 12:00:00 PM,14,,,7,7
03/28/2024 01:00:00 PM,15,,,7,8
03/28/2024 02:00:00 PM,8,,,4,4
03/28/2024 03:00:00 PM,16,,,8,8
03/28/2024 04:00:00 PM,47,,,23,24
03/28/2024 05:00:00 PM,47,,,23,24
03/28/2024 06:00:00 PM,36,,,18,18
03/28/2024 07:00:00 PM,12,,,6,6
03/28/2024 08:00:00 PM,5,,,2,3
03/28/2024 09:00:00 PM,4,,,2,2
03/28/2024 10:00:00 PM,1,,,0,1
03/28/2024 11:00:00 PM,2,,,1,1
03/29/2024 12:00:00 AM,0,,,0,0
03/29/2024 01:00:00 AM,0,,,0,0
03/29/2024 02:00:00 AM,0,,,0,0
03/29/2024 03:00:00 AM,0,,,0,0
03/29/2024 04:00:00 AM,0,,,0,0
03/29/2024 05:00:00 AM,7,,,3,4
03/29/2024 06:00:00 AM,16,,,8,8
03/29/2024 07:00:00 AM,25,,,12,13
03/29/2024 08:00:00 AM,31,,,15,16
03/29/2024 09:00:00 AM,23,,,11,12
03/29/2024 10:00:00 AM,57,,,28,29
03/29/2024 11:00:00 AM,70,,,35,35
03/29/2024 12:00:00 PM,68,,,34,34
03/29/2024 01:00:00 PM,82,,,41,41
03/29/2024 02:00:00 PM,89,,,44,45
03/29/2024 03:00:00 PM,118,,,59,59
03/29/2024 04:00:00 PM,106,,,53,53
03/29/2024 05:00:00 PM,98,,,49,49
03/29/2024 06:00:00 PM,73,,,36,37
03/29/2024 07:00:00 PM,20,,,10,10
03/29/2024 08:00:00 PM,8,,,4,4
03/29/2024 09:00:00 PM,3,,,1,2
03/29/2024 10:00:00 PM,7,,,3,4
03/29/2024 11:00:00 PM,2,,,1,1
03/30/2024 12:00:00 AM,1,,,0,1
03/30/2024 01:00:00 AM,0,,,0,0
03/30/2024 02:00:00 AM,0,,,0,0
03/30/2024 03:00:00 AM,0,,,0,0
03/30/2024 04:00:00 AM,0,,,0,0
03/30/2024 05:00:00 AM,0,,,0,0
03/30/2024 06:00:00 AM,10,,,5,5
03/30/2024 07:00:00 AM,30,,,15,15
03/30/2024 08:00:00 AM,57,,,28,29
03/30/2024 09:00:00 AM,81,,,40,41
03/30/2024 10:00:00 AM,176,,,88,88
03/30/2024 11:00:00 AM,182,,,91,91
03/30/2024 12:00:00 PM,225,,,112,113
03/30/2024 01:00:00 PM,188,,,94,94
03/30/2024 02:00:00 PM,191,,,95,96
03/30/2024 03:00:00 PM,228,,,114,114
03/30/2024 04:00:00 PM,132,,,66,66
03/30/2024 05:00:00 PM,89,,,44,45
03/30/2024 06:00:00 PM,52,,,26,26
03/30/2024 07:00:00 PM,20,,,10,10
03/30/2024 08:00:00 PM,4,,,2,2
03/30/2024 09:00:00 PM,5,,,2,3
03/30/2024 10:00:00 PM,0,,,0,0
03/30/2024 11:00:00 PM,0,,,0,0
03/31/2024 12:00:00 AM,2,,,1,1
03/31/2024 01:00:00 AM,0,,,0,0
03/31/2024 02:00:00 AM,0,,,0,0
03/31/2024 03:00:00 AM,0,,,0,0
03/31/2024 04:00:00 AM,0,,,0,0
03/31/2024 05:00:00 AM,0,,,0,0
03/31/2024 06:00:00 AM,4,,,2,2
03/31/2024 07:00:00 AM,21,,,10,11
03/31/2024 08:00:00 AM,46,,,23,23
03/31/2024 09:00:00 AM,90,,,45,45
03/31/2024 10:00:00 AM,98,,,49,49
03/31/2024 11:00:00 AM,149,,,74,75
03/31/2024 12:00:00 PM,186,,,93,93
03/31/2024 01:00:00 PM,177,,,88,89
03/31/2024 02:00:00 PM,264,,,132,132
03/31/2024 03:00:00 PM,216,,,108,108
03/31/2024 04:00:00 PM,201,,,100,101
03/31/2024 05:00:00 PM,148,,,74,74
03/31/2024 06:00:00 PM,67,,,33,34
03/31/2024 07:00:00 PM,26,,,13,13
03/31/2024 08:00:00 PM,4,,,2,2
03/31/2024 09:00:00 PM,5,,,2,3
03/31/2024 10:00:00 PM,0,,,0,0
03/31/2024 11:00:00 PM,1,,,0,1
04/01/2024 12:00:00 AM,1,,,0,1
04/01/2024 01:00:00 AM,0,,,0,0
04/01/2024 02:00:00 AM,0,,,0,0
04/01/2024 03:00:00 AM,0,,,0,0
04/01/2024 04:00:00 AM,0,,,0,0
04/01/2024 05:00:00 AM,2,,,1,1
04/01/2024 06:00:00 AM,18,,,9,9
04/01/2024 07:00:00 AM,37,,,18,19
04/01/2024 08:00:00 AM,45,,,22,23
04/01/2024 09:00:00 AM,36,,,18,18
04/01/2024 10:00:00 AM,60,,,30,30
04/01/2024 11:00:00 AM,56,,,28,28
04/01/2024 12:00:00 PM,55,,,27,28
04/01/2024 01:00:00 PM,75,,,37,38
04/01/2024 02:00:00 PM,89,,,44,45
04/01/2024 03:00:00 PM,77,,,38,39
04/01/2024 04:00:00 PM,98,,,49,49
04/01/2024 05:00:00 PM,119,,,59,60
04/01/2024 06:00:00 PM,99,,,49,50
04/01/2024 07:00:00 PM,45,,,22,23
04/01/2024 08:00:00 PM,15,,,7,8
04/01/2024 09:00:00 PM,2,,,1,1
04/01/2024 10:00:00 PM,5,,,2,3
04/01/2024 11:00:00 PM,1,,,0,1
04/02/2024 12:00:00 AM,2,,,1,1
04/02/2024 01:00:00 AM,2,,,1,1
04/02/2024 02:00:00 AM,0,,,0,0
04/02/2024 03:00:00 AM,0,,,0,0
04/02/2024 04:00:00 AM,2,,,1,1
04/02/2024 05:00:00 AM,5,,,2,3
04/02/2024 06:00:00 AM,22,,,11,11
04/02/2024 07:00:00 AM,44,,,22,22
04/02/2024 08:00:00 AM,68,,,34,34
04/02/2024 09:00:00 AM,54,,,27,27
04/02/2024 10:00:00 AM,55,,,27,28
04/02/2024 11:00:00 AM,41,,,20,21
04/02/2024 12:00:00 PM,66,,,33,33
04/02/2024 01:00:00 PM,88,,,44,44
04/02/2024 02:00:00 PM,96,,,48,48
04/02/2024 03:00:00 PM,110,,,55,55
04/02/2024 04:00:00 PM,109,,,54,55
04/02/2024 05:00:00 PM,179,,,89,90
04/02/2024 06:00:00 PM,118,,,59,59
04/02/2024 07:00:00 PM,50,,,25,25
04/02/2024 08:00:00 PM,9,,,4,5
04/02/2024 09:00:00 PM,5,,,2,3
04/02/2024 10:00:00 PM,3,,,1,2
04/02/2024 11:00:00 PM,0,,,0,0
04/03/2024 12:00:00 AM,0,,,0,0
04/03/2024 01:00:00 AM,0,,,0,0
04/03/2024 02:00:00 AM,0,,,0,0
04/03/2024 03:00:00 AM,0,,,0,0
04/03/2024 04:00:00 AM,0,,,0,0
04/03/2024 05:00:00 AM,2,,,1,1
04/03/2024 06:00:00 AM,17,,,8,9
04/03/2024 07:00:00 AM,25,,,12,13
04/03/2024 08:00:00 AM,39,,,19,20
04/03/2024 09:00:00 AM,29,,,14,15
04/03/2024 10:00:00 AM,27,,,13,14
04/03/2024 11:00:00 AM,35,,,17,18
04/03/2024 12:00:00 PM,23,,,11,12
04/03/2024 01:00:00 PM,37,,,18,19
04/03/2024 02:00:00 PM,41,,,20,21
04/03/2024 03:00:00 PM,48,,,24,24
04/03/2024 04:00:00 PM,55,,,27,28
04/03/2024 05:00:00 PM,77,,,38,39
04/03/2024 06:00:00 PM,73,,,36,37
04/03/2024 07:00:00 PM,33,,,16,17
04/03/2024 08:00:00 PM,11,,,5,6
04/03/2024 09:00:00 PM,9,,,4,5
04/03/2024 10:00:00 PM,6,,,3,3
04/03/2024 11:00:00 PM,0,,,0,0
04/04/2024 12:00:00 AM,0,,,0,0
04/04/2024 01:00:00 AM,0,,,0,0
04/04/2024 02:00:00 AM,0,,,0,0
04/04/2024 03:00:00 AM,0,,,0,0
04/04/2024 04:00:00 AM,1,,,0,1
04/04/2024 05:00:00 AM,4,,,2,2
04/04/2024 06:00:00 AM,15,,,7,8
04/04/2024 07:00:00 AM,33,,,16,17
04/04/2024 08:00:00 AM,51,,,25,26
04/04/2024 09:00:00 AM,23,,,11,12
04/04/2024 10:00:00 AM,26,,,13,13
04/04/2024 11:00:00 AM,22,,,11,11
04/04/2024 12:00:00 PM,18,,,9,9
04/04/2024 01:00:00 PM,17,,,8,9
04/04/2024 02:00:00 PM,24,,,12,12
04/04/2024 03:00:00 PM,31,,,15,16
04/04/2024 04:00:00 PM,50,,,25,25
04/04/2024 05:00:00 PM,41,,,20,21
04/04/2024 06:00:00 PM,28,,,14,14
04/04/2024 07:00:00 PM,12,,,6,6
04/04/2024 08:00:00 PM,3,,,1,2
04/04/2024 09:00:00 PM,11,,,5,6
04/04/2024 10:00:00 PM,1,,,0,1
04/04/2024 11:00:00 PM,1,,,0,1
04/05/2024 12:00:00 AM,0,,,0,0
04/05/2024 01:00:00 AM,0,,,0,0
04/05/2024 02:00:00 AM,0,,,0,0
04/05/2024 03:00:00 AM,0,,,0,0
04/05/2024 04:00:00 AM,1,,,0,1
04/05/2024 05:00:00 AM,2,,,1,1
04/05/2024 06:00:00 AM,15,,,7,8
04/05/2024 07:00:00 AM,23,,,11,12
04/05/2024 08:00:00 AM,35,,,17,18
04/05/2024 09:00:00 AM,22,,,11,11
04/05/2024 10:00:00 AM,76,,,38,38
04/05/2024 11:00:00 AM,78,,,39,39
04/05/2024 12:00:00 PM,28,,,14,14
04/05/2024 01:00:00 PM,30,,,15,15
04/05/2024 02:00:00 PM,39,,,19,20
04/05/2024 03:00:00 PM,57,,,28,29
04/05/2024 04:00:00 PM,52,,,26,26
04/05/2024 05:00:00 PM,72,,,36,36
04/05/2024 06:00:00 PM,42,,,21,21
04/05/2024 07:00:00 PM,15,,,7,8
04/05/2024 08:00:00 PM,4,,,2,2
04/05/2024 09:00:00 PM,4,,,2,2
04/05/2024 10:00:00 PM,0,,,0,0
04/05/2024 11:00:00 PM,0,,,0,0
04/06/2024 12:00:00 AM,0,,,0,0
04/06/2024 01:00:00 AM,0,,,0,0
04/06/2024 02:00:00 AM,0,,,0,0
04/06/2024 03:00:00 AM,0,,,0,0
04/06/2024 04:00:00 AM,0,,,0,0
04/06/2024 05:00:00 AM,2,,,1,1
04/06/2024 06:00:00 AM,4,,,2,2
04/06/2024 07:00:00 AM,25,,,12,13
04/06/2024 08:00:00 AM,44,,,22,22
04/06/2024 09:00:00 AM,81,,,40,41
04/06/2024 10:00:00 AM,118,,,59,59
04/06/2024 11:00:00 AM,143,,,71,72
04/06/2024 12:00:00 PM,93,,,46,47
04/06/2024 01:00:00 PM,108,,,54,54
04/06/2024 02:00:00 PM,92,,,46,46
04/06/2024 03:00:00 PM,62,,,31,31
04/06/2024 04:00:00 PM,55,,,27,28
04/06/2024 05:00:00 PM,33,,,16,17
04/06/2024 06:00:00 PM,32,,,16,16
04/06/2024 07:00:00 PM,10,,,5,5
04/06/2024 08:00:00 PM,1,,,0,1
04/06/2024 09:00:00 PM,4,,,2,2
04/06/2024 10:00:00 PM,1,,,0,1
04/06/2024 11:00:00 PM,1,,,0,1
04/07/2024 12:00:00 AM,0,,,0,0
04/07/2024 01:00:00 AM,0,,,0,0
04/07/2024 02:00:00 AM,0,,,0,0
04/07/2024 03:00:00 AM,0,,,0,0
04/07/2024 04:00:00 AM,0,,,0,0
04/07/2024 05:00:00 AM,1,,,0,1
04/07/2024 06:00:00 AM,3,,,1,2
04/07/2024 07:00:00 AM,6,,,3,3
04/07/2024 08:00:00 AM,28,,,14,14
04/07/2024 09:00:00 AM,71,,,35,36
04/07/2024 10:00:00 AM,74,,,37,37
04/07/2024 11:00:00 AM,120,,,60,60
04/07/2024 12:00:00 PM,98,,,49,49
04/07/2024 01:00:00 PM,122,,,61,61
04/07/2024 02:00:00 PM,130,,,65,65
04/07/2024 03:00:00 PM,154,,,77,77
04/07/2024 04:00:00 PM,94,,,47,47
04/07/2024 05:00:00 PM,52,,,26,26
04/07/2024 06:00:00 PM,37,,,18,19
04/07/2024 07:00:00 PM,17,,,8,9
04/07/2024 08:00:00 PM,3,,,1,2
04/07/2024 09:00:00 PM,3,,,1,2
04/07/2024 10:00:00 PM,0,,,0,0
04/07/2024 11:00:00 PM,1,,,0,1
04/08/2024 12:00:00 AM,0,,,0,0
04/08/2024 01:00:00 AM,0,,,0,0
04/08/2024 02:00:00 AM,0,,,0,0
04/08/2024 03:00:00 AM,0,,,0,0
04/08/2024 04:00:00 AM,1,,,0,1
04/08/2024 05:00:00 AM,4,,,2,2
04/08/2024 06:00:00 AM,15,,,7,8
04/08/2024 07:00:00 AM,18,,,9,9
04/08/2024 08:00:00 AM,36,,,18,18
04/08/2024 09:00:00 AM,14,,,7,7
04/08/2024 10:00:00 AM,10,,,5,5
04/08/2024 11:00:00 AM,14,,,7,7
04/08/2024 12:00:00 PM,9,,,4,5
04/08/2024 01:00:00 PM,25,,,12,13
04/08/2024 02:00:00 PM,16,,,8,8
04/08/2024 03:00:00 PM,38,,,19,19
04/08/2024 04:00:00 PM,41,,,20,21
04/08/2024 05:00:00 PM,37,,,18,19
04/08/2024 06:00:00 PM,28,,,14,14
04/08/2024 07:00:00 PM,14,,,7,7
04/08/2024 08:00:00 PM,7,,,3,4
04/08/2024 09:00:00 PM,0,,,0,0
04/08/2024 10:00:00 PM,1,,,0,1
04/08/2024 11:00:00 PM,1,,,0,1
04/09/2024 12:00:00 AM,0,,,0,0
04/09/2024 01:00:00 AM,0,,,0,0
04/09/2024 02:00:00 AM,0,,,0,0
04/09/2024 03:00:00 AM,0,,,0,0
04/09/2024 04:00:00 AM,2,,,1,1
04/09/2024 05:00:00 AM,4,,,2,2
04/09/2024 06:00:00 AM,7,,,3,4
04/09/2024 07:00:00 AM,19,,,9,10
04/09/2024 08:00:00 AM,35,,,17,18
04/09/2024 09:00:00 AM,12,,,6,6
04/09/2024 10:00:00 AM,11,,,5,6
04/09/2024 11:00:00 AM,12,,,6,6
04/09/2024 12:00:00 PM,29,,,14,15
04/09/2024 01:00:00 PM,37,,,18,19
04/09/2024 02:00:00 PM,43,,,21,22
04/09/2024 03:00:00 PM,43,,,21,22
04/09/2024 04:00:00 PM,52,,,26,26
04/09/2024 05:00:00 PM,76,,,38,38
04/09/2024 06:00:00 PM,57,,,28,29
04/09/2024 07:00:00 PM,40,,,20,20
04/09/2024 08:00:00 PM,8,,,4,4
04/09/2024 09:00:00 PM,5,,,2,3
04/09/2024 10:00:00 PM,3,,,1,2
04/09/2024 11:00:00 PM,1,,,0,1
04/10/2024 12:00:00 AM,0,,,0,0
04/10/2024 01:00:00 AM,0,,,0,0
04/10/2024 02:00:00 AM,0,,,0,0
04/10/2024 03:00:00 AM,0,,,0,0
04/10/2024 04:00:00 AM,0,,,0,0
04/10/2024 05:00:00 AM,3,,,1,2
04/10/2024 06:00:00 AM,17,,,8,9
04/10/2024 07:00:00 AM,43,,,21,22
04/10/2024 08:00:00 AM,44,,,22,22
04/10/2024 09:00:00 AM,35,,,17,18
04/10/2024 10:00:00 AM,25,,,12,13
04/10/2024 11:00:00 AM,62,,,31,31
04/10/2024 12:00:00 PM,65,,,32,33
04/10/2024 01:00:00 PM,64,,,32,32
04/10/2024 02:00:00 PM,78,,,39,39
04/10/2024 03:00:00 PM,81,,,40,41
04/10/2024 04:00:00 PM,120,,,60,60
04/10/2024 05:00:00 PM,117,,,58,59
04/10/2024 06:00:00 PM,105,,,52,53
04/10/2024 07:00:00 PM,46,,,23,23
04/10/2024 08:00:00 PM,11,,,5,6
04/10/2024 09:00:00 PM,1,,,0,1
04/10/2024 10:00:00 PM,3,,,1,2
04/10/2024 11:00:00 PM,0,,,0,0
04/11/2024 12:00:00 AM,2,,,1,1
04/11/2024 01:00:00 AM,0,,,0,0
04/11/2024 02:00:00 AM,0,,,0,0
04/11/2024 03:00:00 AM,0,,,0,0
04/11/2024 04:00:00 AM,2,,,1,1
04/11/2024 05:00:00 AM,3,,,1,2
04/11/2024 06:00:00 AM,17,,,8,9
04/11/2024 07:00:00 AM,31,,,15,16
04/11/2024 08:00:00 AM,44,,,22,22
04/11/2024 09:00:00 AM,30,,,15,15
04/11/2024 10:00:00 AM,31,,,15,16
04/11/2024 11:00:00 AM,33,,,16,17
04/11/2024 12:00:00 PM,33,,,16,17
04/11/2024 01:00:00 PM,44,,,22,22
04/11/2024 02:00:00 PM,56,,,28,28
04/11/2024 03:00:00 PM,43,,,21,22
04/11/2024 04:00:00 PM,64,,,32,32
04/11/2024 05:00:00 PM,72,,,36,36
04/11/2024 06:00:00 PM,61,,,30,31
04/11/2024 07:00:00 PM,31,,,15,16
04/11/2024 08:00:00 PM,9,,,4,5
04/11/2024 09:00:00 PM,10,,,5,5
04/11/2024 10:00:00 PM,1,,,0,1
04/11/2024 11:00:00 PM,1,,,0,1
04/12/2024 12:00:00 AM,0,,,0,0
04/12/2024 01:00:00 AM,0,,,0,0
04/12/2024 02:00:00 AM,0,,,0,0
04/12/2024 03:00:00 AM,0,,,0,0
04/12/2024 04:00:00 AM,1,,,0,1
04/12/2024 05:00:00 AM,2,,,1,1
04/12/2024 06:00:00 AM,6,,,3,3
04/12/2024 07:00:00 AM,21,,,10,11
04/12/2024 08:00:00 AM,42,,,21,21
04/12/2024 09:00:00 AM,53,,,26,27
04/12/2024 10:00:00 AM,33,,,16,17
04/12/2024 11:00:00 AM,45,,,22,23
04/12/2024 12:00:00 PM,40,,,20,20
04/12/2024 01:00:00 PM,40,,,20,20
04/12/2024 02:00:00 PM,66,,,33,33
04/12/2024 03:00:00 PM,77,,,38,39
04/12/2024 04:00:00 PM,97,,,48,49
04/12/2024 05:00:00 PM,83,,,41,42
04/12/2024 06:00:00 PM,64,,,32,32
04/12/2024 07:00:00 PM,46,,,23,23
04/12/2024 08:00:00 PM,10,,,5,5
04/12/2024 09:00:00 PM,2,,,1,1
04/12/2024 10:00:00 PM,3,,,1,2
04/12/2024 11:00:00 PM,3,,,1,2
04/13/2024 12:00:00 AM,1,,,0,1
04/13/2024 01:00:00 AM,2,,,1,1
04/13/2024 02:00:00 AM,0,,,0,0
04/13/2024 03:00:00 AM,0,,,0,0
04/13/2024 04:00:00 AM,0,,,0,0
04/13/2024 05:00:00 AM,1,,,0,1
04/13/2024 06:00:00 AM,9,,,4,5
04/13/2024 07:00:00 AM,29,,,14,15
04/13/2024 08:00:00 AM,69,,,34,35
04/13/2024 09:00:00 AM,112,,,56,56
04/13/2024 10:00:00 AM,130,,,65,65
04/13/2024 11:00:00 AM,156,,,78,78
04/13/2024 12:00:00 PM,181,,,90,91
04/13/2024 01:00:00 PM,190,,,95,95
04/13/2024 02:00:00 PM,212,,,106,106
04/13/2024 03:00:00 PM,185,,,92,93
04/13/2024 04:00:00 PM,168,,,84,84
04/13/2024 05:00:00 PM,105,,,52,53
04/13/2024 06:00:00 PM,77,,,38,39
04/13/2024 07:00:00 PM,33,,,16,17
04/13/2024 08:00:00 PM,10,,,5,5
04/13/2024 09:00:00 PM,2,,,1,1
04/13/2024 10:00:00 PM,2,,,1,1
04/13/2024 11:00:00 PM,0,,,0,0
04/14/2024 12:00:00 AM,1,,,0,1
04/14/2024 01:00:00 AM,0,,,0,0
04/14/2024 02:00:00 AM,0,,,0,0
04/14/2024 03:00:00 AM,0,,,0,0
04/14/2024 04:00:00 AM,0,,,0,0
04/14/2024 05:00:00 AM,1,,,0,1
04/14/2024 06:00:00 AM,5,,,2,3
04/14/2024 07:00:00 AM,28,,,14,14
04/14/2024 08:00:00 AM,52,,,26,26
04/14/2024 09:00:00 AM,87,,,43,44
04/14/2024 10:00:00 AM,137,,,68,69
04/14/2024 11:00:00 AM,183,,,91,92
04/14/2024 12:00:00 PM,219,,,109,110
04/14/2024 01:00:00 PM,249,,,124,125
04/14/2024 02:00:00 PM,256,,,128,128
04/14/2024 03:00:00 PM,220,,,110,110
04/14/2024 04:00:00 PM,224,,,112,112
04/14/2024 05:00:00 PM,137,,,68,69
04/14/2024 06:00:00 PM,101,,,50,51
04/14/2024 07:00:00 PM,44,,,22,22
04/14/2024 08:00:00 PM,14,,,7,7
04/14/2024 09:00:00 PM,2,,,1,1
04/14/2024 10:00:00 PM,0,,,0,0
04/14/2024 11:00:00 PM,2,,,1,1
04/15/2024 12:00:00 AM,0,,,0,0
04/15/2024 01:00:00 AM,0,,,0,0
04/15/2024 02:00:00 AM,0,,,0,0
04/15/2024 03:00:00 AM,0,,,0,0
04/15/2024 04:00:00 AM,3,,,1,2
04/15/2024 05:00:00 AM,4,,,2,2
04/15/2024 06:00:00 AM,20,,,10,10
04/15/2024 07:00:00 AM,36,,,18,18
04/15/2024 08:00:00 AM,37,,,18,19
04/15/2024 09:00:00 AM,25,,,12,13
04/15/2024 10:00:00 AM,27,,,13,14
04/15/2024 11:00:00 AM,18,,,9,9
04/15/2024 12:00:00 PM,23,,,11,12
04/15/2024 01:00:00 PM,22,,,11,11
04/15/2024 02:00:00 PM,28,,,14,14
04/15/2024 03:00:00 PM,29,,,14,15
04/15/2024 04:00:00 PM,48,,,24,24
04/15/2024 05:00:00 PM,61,,,30,31
04/15/2024 06:00:00 PM,32,,,16,16
04/15/2024 07:00:00 PM,27,,,13,14
04/15/2024 08:00:00 PM,14,,,7,7
04/15/2024 09:00:00 PM,3,,,1,2
04/15/2024 10:00:00 PM,1,,,0,1
04/15/2024 11:00:00 PM,1,,,0,1
04/16/2024 12:00:00 AM,0,,,0,0
04/16/2024 01:00:00 AM,0,,,0,0
04/16/2024 02:00:00 AM,0,,,0,0
04/16/2024 03:00:00 AM,0,,,0,0
04/16/2024 04:00:00 AM,1,,,0,1
04/16/2024 05:00:00 AM,2,,,1,1
04/16/2024 06:00:00 AM,18,,,9,9
04/16/2024 07:00:00 AM,50,,,25,25
04/16/2024 08:00:00 AM,50,,,25,25
04/16/2024 09:00:00 AM,28,,,14,14
04/16/2024 10:00:00 AM,26,,,13,13
04/16/2024 11:00:00 AM,27,,,13,14
04/16/2024 12:00:00 PM,31,,,15,16
04/16/2024 01:00:00 PM,18,,,9,9
04/16/2024 02:00:00 PM,32,,,16,16
04/16/2024 03:00:00 PM,47,,,23,24
04/16/2024 04:00:00 PM,56,,,28,28
04/16/2024 05:00:00 PM,93,,,46,47
04/16/2024 06:00:00 PM,94,,,47,47
04/16/2024 07:00:00 PM,36,,,18,18
04/16/2024 08:00:00 PM,14,,,7,7
04/16/2024 09:00:00 PM,9,,,4,5
04/16/2024 10:00:00 PM,2,,,1,1
04/16/2024 11:00:00 PM,0,,,0,0
04/17/2024 12:00:00 AM,1,,,0,1
04/17/2024 01:00:00 AM,0,,,0,0
04/17/2024 02:00:00 AM,0,,,0,0
04/17/2024 03:00:00 AM,0,,,0,0
04/17/2024 04:00:00 AM,0,,,0,0
04/17/2024 05:00:00 AM,6,,,3,3
04/17/2024 06:00:00 AM,20,,,10,10
04/17/2024 07:00:00 AM,45,,,22,23
04/17/2024 08:00:00 AM,48,,,24,24
04/17/2024 09:00:00 AM,29,,,14,15
04/17/2024 10:00:00 AM,36,,,18,18
04/17/2024 11:00:00 AM,51,,,25,26
04/17/2024 12:00:00 PM,47,,,23,24
04/17/2024 01:00:00 PM,68,,,34,34
04/17/2024 02:00:00 PM,67,,,33,34
04/17/2024 03:00:00 PM,88,,,44,44
04/17/2024 04:00:00 PM,103,,,51,52
04/17/2024 05:00:00 PM,131,,,65,66
04/17/2024 06:00:00 PM,103,,,51,52
04/17/2024 07:00:00 PM,80,,,40,40
04/17/2024 08:00:00 PM,28,,,14,14
04/17/2024 09:00:00 PM,8,,,4,4
04/17/2024 10:00:00 PM,2,,,1,1
04/17/2024 11:00:00 PM,0,,,0,0
04/18/2024 12:00:00 AM,1,,,0,1
04/18/2024 01:00:00 AM,0,,,0,0
04/18/2024 02:00:00 AM,0,,,0,0
04/18/2024 03:00:00 AM,0,,,0,0
04/18/2024 04:00:00 AM,0,,,0,0
04/18/2024 05:00:00 AM,6,,,3,3
04/18/2024 06:00:00 AM,19,,,9,10
04/18/2024 07:00:00 AM,50,,,25,25
04/18/2024 08:00:00 AM,46,,,23,23
04/18/2024 09:00:00 AM,51,,,25,26
04/18/2024 10:00:00 AM,44,,,22,22
04/18/2024 11:00:00 AM,51,,,25,26
04/18/2024 12:00:00 PM,50,,,25,25
04/18/2024 01:00:00 PM,68,,,34,34
04/18/2024 02:00:00 PM,72,,,36,36
04/18/2024 03:00:00 PM,78,,,39,39
04/18/2024 04:00:00 PM,104,,,52,52
04/18/2024 05:00:00 PM,129,,,64,65
04/18/2024 06:00:00 PM,107,,,53,54
04/18/2024 07:00:00 PM,64,,,32,32
04/18/2024 08:00:00 PM,35,,,17,18
04/18/2024 09:00:00 PM,10,,,5,5
04/18/2024 10:00:00 PM,6,,,3,3
04/18/2024 11:00:00 PM,0,,,0,0
04/19/2024 12:00:00 AM,0,,,0,0
04/19/2024 01:00:00 AM,0,,,0,0
04/19/2024 02:00:00 AM,0,,,0,0
04/19/2024 03:00:00 AM,0,,,0,0
04/19/2024 04:00:00 AM,2,,,1,1
04/19/2024 05:00:00 AM,7,,,3,4
04/19/2024 06:00:00 AM,21,,,10,11
04/19/2024 07:00:00 AM,38,,,19,19
04/19/2024 08:00:00 AM,46,,,23,23
04/19/2024 09:00:00 AM,50,,,25,25
04/19/2024 10:00:00 AM,66,,,33,33
04/19/2024 11:00:00 AM,76,,,38,38
04/19/2024 12:00:00 PM,69,,,34,35
04/19/2024 01:00:00 PM,111,,,55,56
04/19/2024 02:00:00 PM,133,,,66,67
04/19/2024 03:00:00 PM,117,,,58,59
04/19/2024 04:00:00 PM,154,,,77,77
04/19/2024 05:00:00 PM,162,,,81,81
04/19/2024 06:00:00 PM,120,,,60,60
04/19/2024 07:00:00 PM,55,,,27,28
04/19/2024 08:00:00 PM,29,,,14,15
04/19/2024 09:00:00 PM,5,,,2,3
04/19/2024 10:00:00 PM,2,,,1,1
04/19/2024 11:00:00 PM,4,,,2,2
04/20/2024 12:00:00 AM,0,,,0,0
04/20/2024 01:00:00 AM,0,,,0,0
04/20/2024 02:00:00 AM,1,,,0,1
04/20/2024 03:00:00 AM,0,,,0,0
04/20/2024 04:00:00 AM,0,,,0,0
04/20/2024 05:00:00 AM,2,,,1,1
04/20/2024 06:00:00 AM,13,,,6,7
04/20/2024 07:00:00 AM,41,,,20,21
04/20/2024 08:00:00 AM,60,,,30,30
04/20/2024 09:00:00 AM,143,,,71,72
04/20/2024 10:00:00 AM,192,,,96,96
04/20/2024 11:00:00 AM,252,,,126,126
04/20/2024 12:00:00 PM,294,,,147,147
04/20/2024 01:00:00 PM,300,,,150,150
04/20/2024 02:00:00 PM,258,,,129,129
04/20/2024 03:00:00 PM,201,,,100,101
04/20/2024 04:00:00 PM,93,,,46,47
04/20/2024 05:00:00 PM,45,,,22,23
04/20/2024 06:00:00 PM,22,,,11,11
04/20/2024 07:00:00 PM,12,,,6,6
04/20/2024 08:00:00 PM,14,,,7,7
04/20/2024 09:00:00 PM,11,,,5,6
04/20/2024 10:00:00 PM,5,,,2,3
04/20/2024 11:00:00 PM,2,,,1,1
04/21/2024 12:00:00 AM,0,,,0,0
04/21/2024 01:00:00 AM,3,,,1,2
04/21/2024 02:00:00 AM,0,,,0,0
04/21/2024 03:00:00 AM,0,,,0,0
04/21/2024 04:00:00 AM,0,,,0,0
04/21/2024 05:00:00 AM,4,,,2,2
04/21/2024 06:00:00 AM,8,,,4,4
04/21/2024 07:00:00 AM,23,,,11,12
04/21/2024 08:00:00 AM,53,,,26,27
04/21/2024 09:00:00 AM,83,,,41,42
04/21/2024 10:00:00 AM,113,,,56,57
04/21/2024 11:00:00 AM,147,,,73,74
04/21/2024 12:00:00 PM,122,,,61,61
04/21/2024 01:00:00 PM,205,,,102,103
04/21/2024 02:00:00 PM,177,,,88,89
04/21/2024 03:00:00 PM,154,,,77,77
04/21/2024 04:00:00 PM,101,,,50,51
04/21/2024 05:00:00 PM,68,,,34,34
04/21/2024 06:00:00 PM,29,,,14,15
04/21/2024 07:00:00 PM,29,,,14,15
04/21/2024 08:00:00 PM,11,,,5,6
04/21/2024 09:00:00 PM,1,,,0,1
04/21/2024 10:00:00 PM,1,,,0,1
04/21/2024 11:00:00 PM,0,,,0,0
04/22/2024 12:00:00 AM,0,,,0,0
04/22/2024 01:00:00 AM,1,,,0,1
04/22/2024 02:00:00 AM,0,,,0,0
04/22/2024 03:00:00 AM,0,,,0,0
04/22/2024 04:00:00 AM,0,,,0,0
04/22/2024 05:00:00 AM,1,,,0,1
04/22/2024 06:00:00 AM,19,,,9,10
04/22/2024 07:00:00 AM,40,,,20,20
04/22/2024 08:00:00 AM,58,,,29,29
04/22/2024 09:00:00 AM,40,,,20,20
04/22/2024 10:00:00 AM,31,,,15,16
04/22/2024 11:00:00 AM,43,,,21,22
04/22/2024 12:00:00 PM,47,,,23,24
04/22/2024 01:00:00 PM,60,,,30,30
04/22/2024 02:00:00 PM,61,,,30,31
04/22/2024 03:00:00 PM,89,,,44,45
04/22/2024 04:00:00 PM,109,,,54,55
04/22/2024 05:00:00 PM,141,,,70,71
04/22/2024 06:00:00 PM,88,,,44,44
04/22/2024 07:00:00 PM,44,,,22,22
04/22/2024 08:00:00 PM,10,,,5,5
04/22/2024 09:00:00 PM,7,,,3,4
04/22/2024 10:00:00 PM,4,,,2,2
04/22/2024 11:00:00 PM,0,,,0,0
04/23/2024 12:00:00 AM,0,,,0,0
04/23/2024 01:00:00 AM,0,,,0,0
04/23/2024 02:00:00 AM,0,,,0,0
04/23/2024 03:00:00 AM,1,,,0,1
04/23/2024 04:00:00 AM,0,,,0,0
04/23/2024 05:00:00 AM,8,,,4,4
04/23/2024 06:00:00 AM,30,,,15,15
04/23/2024 07:00:00 AM,59,,,29,30
04/23/2024 08:00:00 AM,60,,,30,30
04/23/2024 09:00:00 AM,49,,,24,25
04/23/2024 10:00:00 AM,56,,,28,28
04/23/2024 11:00:00 AM,48,,,24,24
04/23/2024 12:00:00 PM,84,,,42,42
04/23/2024 01:00:00 PM,68,,,34,34
04/23/2024 02:00:00 PM,87,,,43,44
04/23/2024 03:00:00 PM,100,,,50,50
04/23/2024 04:00:00 PM,135,,,67,68
04/23/2024 05:00:00 PM,193,,,96,97
04/23/2024 06:00:00 PM,144,,,72,72
04/23/2024 07:00:00 PM,78,,,39,39
04/23/2024 08:00:00 PM,30,,,15,15
04/23/2024 09:00:00 PM,7,,,3,4
04/23/2024 10:00:00 PM,0,,,0,0
04/23/2024 11:00:00 PM,2,,,1,1
04/24/2024 12:00:00 AM,1,,,0,1
04/24/2024 01:00:00 AM,0,,,0,0
04/24/2024 02:00:00 AM,0,,,0,0
04/24/2024 03:00:00 AM,0,,,0,0
04/24/2024 04:00:00 AM,1,,,0,1
04/24/2024 05:00:00 AM,3,,,1,2
04/24/2024 06:00:00 AM,22,,,11,11
04/24/2024 07:00:00 AM,45,,,22,23
04/24/2024 08:00:00 AM,65,,,32,33
04/24/2024 09:00:00 AM,41,,,20,21
04/24/2024 10:00:00 AM,29,,,14,15
04/24/2024 11:00:00 AM,45,,,22,23
04/24/2024 12:00:00 PM,18,,,9,9
04/24/2024 01:00:00 PM,27,,,13,14
04/24/2024 02:00:00 PM,34,,,17,17
04/24/2024 03:00:00 PM,32,,,16,16
04/24/2024 04:00:00 PM,36,,,18,18
04/24/2024 05:00:00 PM,60,,,30,30
04/24/2024 06:00:00 PM,46,,,23,23
04/24/2024 07:00:00 PM,18,,,9,9
04/24/2024 08:00:00 PM,10,,,5,5
04/24/2024 09:00:00 PM,10,,,5,5
04/24/2024 10:00:00 PM,3,,,1,2
04/24/2024 11:00:00 PM,0,,,0,0
04/25/2024 12:00:00 AM,1,,,0,1
04/25/2024 01:00:00 AM,0,,,0,0
04/25/2024 02:00:00 AM,0,,,0,0
04/25/2024 03:00:00 AM,0,,,0,0
04/25/2024 04:00:00 AM,1,,,0,1
04/25/2024 05:00:00 AM,7,,,3,4
04/25/2024 06:00:00 AM,7,,,3,4
04/25/2024 07:00:00 AM,24,,,12,12
04/25/2024 08:00:00 AM,26,,,13,13
04/25/2024 09:00:00 AM,18,,,9,9
04/25/2024 10:00:00 AM,7,,,3,4
04/25/2024 11:00:00 AM,5,,,2,3
04/25/2024 12:00:00 PM,3,,,1,2
04/25/2024 01:00:00 PM,7,,,3,4
04/25/2024 02:00:00 PM,9,,,4,5
04/25/2024 03:00:00 PM,12,,,6,6
04/25/2024 04:00:00 PM,20,,,10,10
04/25/2024 05:00:00 PM,44,,,22,22
04/25/2024 06:00:00 PM,17,,,8,9
04/25/2024 07:00:00 PM,10,,,5,5
04/25/2024 08:00:00 PM,8,,,4,4
04/25/2024 09:00:00 PM,6,,,3,3
04/25/2024 10:00:00 PM,1,,,0,1
04/25/2024 11:00:00 PM,1,,,0,1
04/26/2024 12:00:00 AM,0,,,0,0
04/26/2024 01:00:00 AM,0,,,0,0
04/26/2024 02:00:00 AM,1,,,0,1
04/26/2024 03:00:00 AM,0,,,0,0
04/26/2024 04:00:00 AM,1,,,0,1
04/26/2024 05:00:00 AM,4,,,2,2
04/26/2024 06:00:00 AM,12,,,6,6
04/26/2024 07:00:00 AM,12,,,6,6
04/26/2024 08:00:00 AM,30,,,15,15
04/26/2024 09:00:00 AM,20,,,10,10
04/26/2024 10:00:00 AM,28,,,14,14
04/26/2024 11:00:00 AM,35,,,17,18
04/26/2024 12:00:00 PM,29,,,14,15
04/26/2024 01:00:00 PM,49,,,24,25
04/26/2024 02:00:00 PM,52,,,26,26
04/26/2024 03:00:00 PM,85,,,42,43
04/26/2024 04:00:00 PM,76,,,38,38
04/26/2024 05:00:00 PM,91,,,45,46
04/26/2024 06:00:00 PM,76,,,38,38
04/26/2024 07:00:00 PM,39,,,19,20
04/26/2024 08:00:00 PM,8,,,4,4
04/26/2024 09:00:00 PM,6,,,3,3
04/26/2024 10:00:00 PM,11,,,5,6
04/26/2024 11:00:00 PM,1,,,0,1
04/27/2024 12:00:00 AM,5,,,2,3
04/27/2024 01:00:00 AM,3,,,1,2
04/27/2024 02:00:00 AM,0,,,0,0
04/27/2024 03:00:00 AM,0,,,0,0
04/27/2024 04:00:00 AM,1,,,0,1
04/27/2024 05:00:00 AM,0,,,0,0
04/27/2024 06:00:00 AM,9,,,4,5
04/27/2024 07:00:00 AM,36,,,18,18
04/27/2024 08:00:00 AM,44,,,22,22
04/27/2024 09:00:00 AM,63,,,31,32
04/27/2024 10:00:00 AM,120,,,60,60
04/27/2024 11:00:00 AM,105,,,52,53
04/27/2024 12:00:00 PM,79,,,39,40
04/27/2024 01:00:00 PM,50,,,25,25
04/27/2024 02:00:00 PM,33,,,16,17
04/27/2024 03:00:00 PM,61,,,30,31
04/27/2024 04:00:00 PM,50,,,25,25
04/27/2024 05:00:00 PM,37,,,18,19
04/27/2024 06:00:00 PM,30,,,15,15
04/27/2024 07:00:00 PM,14,,,7,7
04/27/2024 08:00:00 PM,7,,,3,4
04/27/2024 09:00:00 PM,5,,,2,3
04/27/2024 10:00:00 PM,0,,,0,0
04/27/2024 11:00:00 PM,1,,,0,1
04/28/2024 12:00:00 AM,0,,,0,0
04/28/2024 01:00:00 AM,0,,,0,0
04/28/2024 02:00:00 AM,0,,,0,0
04/28/2024 03:00:00 AM,0,,,0,0
04/28/2024 04:00:00 AM,0,,,0,0
04/28/2024 05:00:00 AM,0,,,0,0
04/28/2024 06:00:00 AM,6,,,3,3
04/28/2024 07:00:00 AM,14,,,7,7
04/28/2024 08:00:00 AM,41,,,20,21
04/28/2024 09:00:00 AM,63,,,31,32
04/28/2024 10:00:00 AM,81,,,40,41
04/28/2024 11:00:00 AM,87,,,43,44
04/28/2024 12:00:00 PM,109,,,54,55
04/28/2024 01:00:00 PM,101,,,50,51
04/28/2024 02:00:00 PM,66,,,33,33
04/28/2024 03:00:00 PM,74,,,37,37
04/28/2024 04:00:00 PM,51,,,25,26
04/28/2024 05:00:00 PM,40,,,20,20
04/28/2024 06:00:00 PM,26,,,13,13
04/28/2024 07:00:00 PM,21,,,10,11
04/28/2024 08:00:00 PM,14,,,7,7
04/28/2024 09:00:00 PM,2,,,1,1
04/28/2024 10:00:00 PM,0,,,0,0
04/28/2024 11:00:00 PM,0,,,0,0
04/29/2024 12:00:00 AM,0,,,0,0
04/29/2024 01:00:00 AM,0,,,0,0
04/29/2024 02:00:00 AM,0,,,0,0
04/29/2024 03:00:00 AM,0,,,0,0
04/29/2024 04:00:00 AM,0,,,0,0
04/29/2024 05:00:00 AM,1,,,0,1
04/29/2024 06:00:00 AM,15,,,7,8
04/29/2024 07:00:00 AM,15,,,7,8
04/29/2024 08:00:00 AM,33,,,16,17
04/29/2024 09:00:00 AM,14,,,7,7
04/29/2024 10:00:00 AM,19,,,9,10
04/29/2024 11:00:00 AM,25,,,12,13
04/29/2024 12:00:00 PM,25,,,12,13
04/29/2024 01:00:00 PM,36,,,18,18
04/29/2024 02:00:00 PM,26,,,13,13
04/29/2024 03:00:00 PM,36,,,18,18
04/29/2024 04:00:00 PM,37,,,18,19
04/29/2024 05:00:00 PM,42,,,21,21
04/29/2024 06:00:00 PM,27,,,13,14
04/29/2024 07:00:00 PM,13,,,6,7
04/29/2024 08:00:00 PM,5,,,2,3
04/29/2024 09:00:00 PM,3,,,1,2
04/29/2024 10:00:00 PM,2,,,1,1
04/29/2024 11:00:00 PM,0,,,0,0
04/30/2024 12:00:00 AM,2,,,1,1
04/30/2024 01:00:00 AM,2,,,1,1
04/30/2024 02:00:00 AM,0,,,0,0
04/30/2024 03:00:00 AM,0,,,0,0
04/30/2024 04:00:00 AM,1,,,0,1
04/30/2024 05:00:00 AM,4,,,2,2
04/30/2024 06:00:00 AM,20,,,10,10
04/30/2024 07:00:00 AM,40,,,20,20
04/30/2024 08:00:00 AM,54,,,27,27
04/30/2024 09:00:00 AM,30,,,15,15
04/30/2024 10:00:00 AM,33,,,16,17
04/30/2024 11:00:00 AM,48,,,24,24
04/30/2024 12:00:00 PM,32,,,16,16
04/30/2024 01:00:00 PM,46,,,23,23
04/30/2024 02:00:00 PM,56,,,28,28
04/30/2024 03:00:00 PM,53,,,26,27
04/30/2024 04:00:00 PM,83,,,41,42
04/30/2024 05:00:00 PM,115,,,57,58
04/30/2024 06:00:00 PM,83,,,41,42
04/30/2024 07:00:00 PM,62,,,31,31
04/30/2024 08:00:00 PM,18,,,9,9
04/30/2024 09:00:00 PM,5,,,2,3
04/30/2024 10:00:00 PM,1,,,0,1
04/30/2024 11:00:00 PM,0,,,0,0
